store_name,order,order_fin,order_cancel,order_delivery,order_takeout,order_weekday,order_weekend,order_time_11,order_time_12,order_time_13,order_time_14,order_time_15,order_time_16,order_time_17,order_time_18,order_time_19,order_time_20,order_time_21,delta_avg,year_month
あきる野店,1147,945,202,841,306,844,303,91,122,112,101,95,107,106,100,108,109,96,34.11005291005291,201904
さいたま南店,1504,1217,287,1105,399,1104,400,130,135,147,143,142,137,130,113,140,132,155,35.33771569433032,201904
さいたま緑店,1028,847,181,756,272,756,272,95,91,106,95,102,82,90,93,95,95,84,34.29161747343566,201904
さいたま西店,1184,980,204,852,332,870,314,122,101,110,117,105,112,103,112,96,108,98,34.576530612244895,201904
つくば店,1267,1058,209,928,339,936,331,122,119,105,102,128,117,110,107,100,132,125,34.66351606805293,201904
三浦店,1147,922,225,866,281,842,305,114,97,87,112,109,130,99,99,102,100,98,33.90563991323211,201904
三鷹店,1504,1245,259,1116,388,1105,399,139,109,140,144,150,137,141,135,126,150,133,34.29718875502008,201904
上尾店,1325,1086,239,974,351,974,351,127,131,116,105,121,117,113,125,113,118,139,20.253222836095766,201904
上野店,1623,1327,296,1216,407,1193,430,140,151,155,130,139,160,138,153,161,161,135,35.27731725697061,201904
世田谷店,1522,1248,274,1124,398,1112,410,147,140,142,129,146,146,117,114,154,134,153,34.28685897435897,201904
中原店,1527,1267,260,1108,419,1124,403,142,126,139,133,144,143,138,136,146,153,127,34.134175217048146,201904
中店,1199,959,240,889,310,881,318,81,150,84,113,111,108,141,103,112,83,113,34.013555787278406,201904
中野店,1155,959,196,866,289,847,308,103,106,100,124,99,101,101,107,111,104,99,34.360792492179364,201904
久喜店,1295,1049,246,961,334,950,345,111,109,135,122,119,104,112,105,138,120,120,34.471877979027646,201904
九段店,1329,1073,256,973,356,977,352,122,105,112,134,121,100,135,120,130,134,116,34.625349487418454,201904
亀有店,1019,836,183,784,235,746,273,86,105,97,96,96,112,72,74,106,87,88,34.745215311004785,201904
五反田店,1142,972,170,863,279,835,307,101,99,120,90,112,107,98,103,91,107,114,35.254115226337454,201904
代々木店,1356,1097,259,1002,354,993,363,126,124,135,123,129,124,132,120,110,114,119,34.22880583409298,201904
伊勢原店,1445,1185,260,1092,353,1062,383,144,141,131,123,131,112,135,122,126,153,127,34.129957805907175,201904
伊勢崎店,1592,1316,276,1180,412,1168,424,143,143,148,146,147,143,142,136,158,138,148,34.58586626139817,201904
佐倉店,878,716,162,660,218,645,233,86,72,70,94,100,74,88,67,75,73,79,34.34776536312849,201904
佐野店,1496,1249,247,1128,368,1094,402,139,130,141,138,139,132,134,133,133,141,136,34.493995196156924,201904
保土ケ谷店,1263,1024,239,910,353,926,337,121,109,102,124,100,126,132,100,109,119,121,34.7451171875,201904
入間店,1132,932,200,842,290,826,306,104,106,92,93,117,113,106,111,93,92,105,34.44957081545064,201904
八千代店,1243,1013,230,928,315,912,331,111,118,116,108,92,124,113,124,121,102,114,34.47186574531096,201904
八潮店,1206,979,227,924,282,884,322,120,128,93,106,107,96,116,100,113,116,111,33.937691521961185,201904
八王子店,1532,1263,269,1150,382,1122,410,145,154,139,127,139,133,141,147,134,128,145,33.70071258907363,201904
六本木店,1000,807,193,732,268,730,270,84,91,101,94,93,84,93,91,98,87,84,34.679058240396536,201904
前橋店,827,646,181,607,220,606,221,55,86,61,74,85,76,90,73,74,74,79,34.690402476780186,201904
北千住店,993,803,190,745,248,733,260,87,83,84,102,92,87,83,105,94,78,98,33.92901618929016,201904
千葉中央店,1263,1034,229,947,316,929,334,107,119,118,108,109,103,125,115,110,120,129,34.6431334622824,201904
千葉緑店,1147,942,205,857,290,842,305,117,93,90,82,114,111,89,115,104,117,115,34.26008492569002,201904
南砂店,1271,1033,238,942,329,929,342,120,121,110,96,128,124,95,118,112,126,121,34.08518877057115,201904
南足柄店,1004,804,200,721,283,738,266,85,85,101,85,98,84,87,92,80,106,101,34.44029850746269,201904
厚木店,1449,1164,285,1055,394,1059,390,138,130,129,127,130,118,148,135,137,125,132,34.128865979381445,201904
取手店,1145,932,213,831,314,843,302,87,111,100,101,107,106,88,110,99,123,113,34.842274678111586,201904
向島店,1027,854,173,731,296,752,275,101,94,105,95,85,99,98,81,98,84,87,34.68969555035129,201904
君津店,1089,913,176,814,275,801,288,77,90,110,97,96,104,99,83,98,117,118,34.24644030668127,201904
和光店,1299,1051,248,955,344,951,348,113,128,109,120,107,117,122,144,116,97,126,34.0209324452902,201904
品川店,1444,1203,241,1061,383,1060,384,124,121,134,126,134,124,140,140,128,137,136,34.47298420615129,201904
四街道店,820,663,157,607,213,602,218,72,87,82,69,77,73,69,73,65,77,76,33.8552036199095,201904
国分寺店,963,798,165,698,265,705,258,76,73,87,92,95,104,103,78,87,84,84,35.19423558897243,201904
国立店,1343,1082,261,991,352,985,358,134,112,120,126,118,128,110,115,110,148,122,34.670055452865064,201904
坂戸店,1148,927,221,846,302,843,305,92,117,96,93,104,108,118,111,124,99,86,34.88781014023733,201904
墨田店,967,791,176,701,266,711,256,83,96,92,76,83,89,86,81,90,104,87,34.91403286978508,201904
多摩店,1061,857,204,790,271,778,283,87,100,97,108,98,96,94,93,85,101,102,34.7467911318553,201904
大久保店,1027,870,157,765,262,753,274,92,104,101,91,87,100,92,97,87,92,84,33.93333333333333,201904
大井店,1174,963,211,859,315,857,317,96,99,121,108,122,102,103,110,115,99,99,33.94496365524403,201904
大和店,1335,1081,254,989,346,981,354,123,110,122,114,113,125,124,117,113,152,122,34.88251618871416,201904
大塚店,1099,891,208,789,310,806,293,114,102,88,92,110,99,105,102,85,103,99,35.29405162738496,201904
大宮店,1324,1086,238,987,337,974,350,129,137,116,126,121,119,94,125,114,123,120,35.08747697974217,201904
大森店,1379,1141,238,1016,363,1013,366,118,107,123,120,154,143,130,131,107,121,125,33.935144609991234,201904
大泉店,1176,943,233,881,295,866,310,116,109,103,113,106,114,107,103,83,112,110,35.390243902439025,201904
大田店,913,738,175,664,249,669,244,73,76,99,82,70,77,91,92,92,85,76,34.233062330623305,201904
太田店,1324,1098,226,984,340,974,350,104,114,110,129,127,119,133,101,129,124,134,35.3688524590164,201904
宇都宮店,1062,880,182,796,266,779,283,100,104,87,88,90,106,92,97,99,96,103,34.657954545454544,201904
守谷店,1154,962,192,829,325,849,305,118,108,112,97,93,96,106,98,97,108,121,35.197505197505194,201904
宮前店,707,560,147,524,183,518,189,69,61,59,63,67,54,62,73,70,60,69,34.175,201904
富岡店,1058,848,210,771,287,775,283,104,108,100,119,86,82,112,92,76,74,105,34.992924528301884,201904
富津店,996,807,189,738,258,731,265,97,85,89,93,110,78,102,79,87,103,73,34.07930607187113,201904
富里店,1445,1202,243,1068,377,1057,388,117,133,119,144,141,124,158,143,136,119,111,34.41597337770383,201904
小山店,993,800,193,763,230,727,266,83,105,90,100,66,79,94,91,97,95,93,34.265,201904
小平店,973,772,201,703,270,711,262,81,80,96,99,88,87,96,95,81,89,81,33.851036269430054,201904
小田原店,879,728,151,640,239,641,238,79,86,89,89,77,75,76,79,75,67,87,34.28846153846154,201904
小金井店,1061,875,186,788,273,777,284,91,95,80,97,100,95,99,92,110,102,100,34.64114285714286,201904
川口店,1085,890,195,800,285,793,292,95,113,104,96,88,96,95,100,101,85,112,33.86292134831461,201904
川崎多摩店,1087,877,210,806,281,795,292,93,102,96,112,109,99,104,96,103,87,86,34.62713797035348,201904
川崎店,1181,967,214,876,305,868,313,108,104,100,116,91,122,99,121,108,100,112,48.62771458117891,201904
川越店,1122,911,211,817,305,823,299,112,100,104,100,106,96,82,107,98,100,117,48.902305159165756,201904
巣鴨店,1473,1206,267,1102,371,1079,394,177,141,134,109,118,149,133,145,120,121,126,34.985903814262024,201904
市原店,1152,916,236,865,287,845,307,109,104,102,106,113,115,97,122,99,100,85,33.83296943231441,201904
市川店,1157,921,236,853,304,846,311,98,117,104,113,110,120,100,90,100,99,106,48.34419109663409,201904
平塚店,1144,921,223,857,287,840,304,109,114,91,102,106,92,104,107,100,129,90,34.00217155266015,201904
幸店,1391,1151,240,1025,366,1021,370,135,135,113,136,122,104,109,128,146,124,139,34.67419635099913,201904
府中店,1207,977,230,912,295,884,323,111,107,120,109,112,109,96,102,114,110,117,34.55783009211873,201904
座間店,1329,1105,224,991,338,978,351,131,138,111,113,126,119,129,115,129,109,109,34.945701357466056,201904
志木店,885,714,171,652,233,649,236,76,80,91,86,81,75,79,68,95,76,78,34.330532212885146,201904
恵比寿店,1000,826,174,738,262,733,267,81,77,94,87,81,83,92,97,96,99,113,20.11864406779661,201904
愛甲店,1029,858,171,760,269,756,273,100,85,86,88,101,111,85,87,86,95,105,35.15617715617716,201904
成城店,1326,1058,268,978,348,971,355,117,120,111,129,118,129,115,115,133,129,110,34.4187145557656,201904
成田店,856,719,137,620,236,627,229,72,73,71,85,87,66,104,63,81,95,59,34.208623087621696,201904
我孫子店,1086,871,215,806,280,797,289,107,80,84,97,105,105,103,110,102,94,99,20.091848450057405,201904
戸塚店,1494,1213,281,1122,372,1099,395,140,144,146,125,113,143,164,128,129,130,132,34.48969497114592,201904
戸田店,1510,1217,293,1112,398,1110,400,123,128,139,133,129,144,137,151,144,147,135,33.89646672144618,201904
所沢店,1149,937,212,865,284,844,305,94,104,113,89,107,114,122,90,105,114,97,34.475987193169686,201904
新宿店,1060,859,201,788,272,775,285,95,99,92,100,97,79,110,106,97,91,94,34.264260768335284,201904
新座店,997,805,192,741,256,729,268,89,82,77,100,90,107,88,95,75,97,97,34.38012422360249,201904
日本橋店,1411,1136,275,1028,383,1036,375,131,138,125,106,149,128,120,130,135,135,114,34.357394366197184,201904
日立店,1262,1053,209,939,323,925,337,126,116,105,109,112,133,127,95,91,128,120,34.68186134852802,201904
日野店,1116,890,226,823,293,819,297,116,92,92,95,89,110,112,110,107,87,106,34.47078651685393,201904
旭店,1204,982,222,877,327,884,320,111,111,110,116,95,125,110,110,115,92,109,34.83808553971487,201904
春日部店,1152,935,217,880,272,845,307,104,105,123,103,100,100,114,103,110,103,87,34.9475935828877,201904
昭島店,1179,955,224,860,319,866,313,109,106,126,102,100,98,100,126,94,116,102,33.36125654450261,201904
木更津店,1086,874,212,790,296,798,288,100,94,99,82,110,95,111,101,96,114,84,34.7299771167048,201904
本庄店,1146,954,192,838,308,840,306,129,82,114,81,95,118,118,98,123,93,95,34.91719077568134,201904
本郷店,738,605,133,522,216,539,199,63,61,66,67,64,71,64,61,61,82,78,47.69256198347106,201904
杉並店,1193,979,214,875,318,873,320,116,95,95,114,109,98,114,115,100,122,115,34.74259448416752,201904
東中野店,1380,1150,230,1022,358,1013,367,116,120,123,137,115,148,121,129,122,141,108,34.11217391304348,201904
東久留米店,847,685,162,640,207,618,229,66,83,76,78,85,90,63,88,60,66,92,35.18686131386861,201904
東大和店,1059,843,216,755,304,777,282,95,93,97,101,97,91,90,97,104,95,99,34.7508896797153,201904
東尾久店,1175,962,213,871,304,859,316,110,105,92,121,104,99,100,108,111,114,111,35.020790020790024,201904
東村山店,1022,839,183,751,271,751,271,83,91,97,89,102,84,107,78,99,85,107,34.969010727056016,201904
東松山店,1296,1050,246,954,342,949,347,129,118,133,103,112,118,114,110,135,120,104,34.53142857142857,201904
松戸店,1208,983,225,892,316,888,320,108,140,97,107,107,126,104,98,96,111,114,34.745676500508644,201904
板橋店,1059,871,188,782,277,779,280,99,91,92,87,99,91,96,106,94,92,112,48.376578645235355,201904
柏店,1471,1212,259,1111,360,1076,395,147,141,139,127,117,121,140,134,118,150,137,34.98432343234323,201904
栃木店,1059,879,180,790,269,777,282,77,106,91,97,104,104,85,102,95,100,98,33.77929465301479,201904
栄店,1528,1251,277,1134,394,1120,408,129,147,128,155,145,136,149,137,139,125,138,20.52517985611511,201904
桐生店,1211,1003,208,885,326,890,321,121,105,102,109,113,98,131,121,108,95,108,33.82552342971087,201904
横浜南店,1382,1107,275,1042,340,1015,367,116,117,132,127,120,127,122,141,127,120,133,34.0903342366757,201904
横浜緑店,1272,1054,218,952,320,933,339,113,90,117,94,114,115,120,132,125,141,111,34.65180265654649,201904
横須賀店,1059,873,186,777,282,776,283,98,90,96,104,89,89,117,94,85,99,98,34.89919816723941,201904
武蔵村山店,1273,1033,240,923,350,933,340,93,125,122,126,108,125,109,126,120,99,120,34.70087124878993,201904
武蔵野店,1055,852,203,777,278,778,277,87,80,98,100,86,93,114,102,99,95,101,34.17253521126761,201904
水戸店,1351,1131,220,1024,327,991,360,138,105,114,119,120,114,113,144,142,128,114,34.809902740937225,201904
江戸川店,1146,953,193,840,306,842,304,115,120,98,101,81,101,103,103,110,94,120,33.766002098635894,201904
江東店,1206,996,210,892,314,881,325,88,106,129,118,108,128,92,115,106,107,109,34.98694779116466,201904
池尻店,1182,949,233,856,326,867,315,116,102,110,117,132,105,101,105,100,88,106,33.962065331928336,201904
池袋店,1405,1145,260,1038,367,1030,375,134,122,127,116,132,149,124,122,133,123,123,35.23755458515284,201904
泉店,1436,1154,282,1070,366,1053,383,126,127,120,149,155,102,130,131,123,140,133,34.59792027729636,201904
流山店,1469,1162,307,1098,371,1077,392,150,119,137,143,143,144,105,134,151,126,117,34.96815834767642,201904
浅草店,1355,1100,255,1012,343,992,363,146,119,116,117,117,122,132,131,120,115,120,34.35090909090909,201904
浦和店,1265,1028,237,948,317,930,335,102,118,110,103,134,115,93,133,137,105,115,34.69844357976654,201904
浦安店,1305,1065,240,974,331,956,349,102,102,114,110,127,113,121,140,116,130,130,33.942723004694834,201904
海老名店,1152,923,229,840,312,847,305,107,110,110,106,105,105,101,114,94,97,103,33.93282773564464,201904
清瀬店,1031,838,193,753,278,758,273,92,96,100,71,94,98,91,96,103,93,97,35.27326968973747,201904
渋谷店,1114,925,189,811,303,818,296,100,97,97,97,99,85,115,128,99,93,104,34.56864864864865,201904
港北店,1003,814,189,741,262,735,268,93,82,89,97,97,94,111,83,91,89,77,21.165847665847664,201904
港南店,1204,966,238,875,329,885,319,107,107,109,99,94,115,92,124,117,111,129,34.42132505175984,201904
瀬谷店,1402,1139,263,1042,360,1025,377,130,109,120,112,142,131,142,133,129,126,128,34.58647936786655,201904
熊谷店,1086,891,195,796,290,797,289,99,90,95,94,119,103,110,99,87,98,92,34.670033670033675,201904
狛江店,1214,988,226,880,334,890,324,101,119,113,113,114,123,111,105,110,103,102,35.04655870445344,201904
狭山店,1375,1104,271,1014,361,1012,363,125,108,119,122,117,135,127,125,130,132,135,34.43115942028985,201904
王子店,1115,915,200,829,286,815,300,108,99,88,93,91,115,106,83,108,120,104,20.8448087431694,201904
町田店,1296,1057,239,975,321,952,344,121,111,110,126,119,130,111,106,131,109,122,34.74361400189215,201904
白井店,1055,855,200,736,319,777,278,100,106,99,80,99,95,89,106,109,94,78,48.57426900584795,201904
目黒店,1172,969,203,862,310,860,312,90,106,108,113,119,115,103,113,116,95,94,34.119711042311664,201904
相模原店,1436,1185,251,1087,349,1052,384,120,122,143,139,143,108,131,115,132,124,159,34.47088607594937,201904
石神井店,935,746,189,688,247,688,247,72,89,79,83,86,80,82,107,83,93,81,46.79222520107238,201904
磯子店,908,752,156,678,230,664,244,84,84,90,82,88,93,70,86,72,86,73,33.65558510638298,201904
神奈川店,1341,1076,265,968,373,983,358,125,115,133,119,137,110,134,123,109,124,112,34.02137546468401,201904
神田店,1407,1127,280,1060,347,1033,374,145,124,108,126,141,126,123,125,126,129,134,34.42857142857143,201904
福生店,1327,1078,249,1003,324,970,357,136,114,119,112,118,123,111,126,125,109,134,34.72541743970315,201904
秦野店,1200,996,204,897,303,878,322,109,105,106,115,96,114,114,105,128,111,97,34.18172690763052,201904
稲城店,946,769,177,681,265,696,250,65,83,102,78,97,78,86,90,91,86,90,48.08322496749025,201904
立川店,1272,1041,231,935,337,932,340,116,134,136,104,120,94,119,95,135,114,105,34.64457252641692,201904
綾瀬店,2625,2148,477,1935,690,1929,696,227,246,241,238,226,266,219,234,232,251,245,34.69180633147113,201904
練馬店,1380,1127,253,1033,347,1011,369,112,119,125,107,109,121,142,154,127,122,142,34.933451641526176,201904
羽村店,1347,1095,252,995,352,987,360,126,113,119,130,125,113,122,129,133,114,123,20.42283105022831,201904
羽生店,1293,1041,252,954,339,947,346,128,110,127,113,98,140,123,119,126,97,112,34.517771373679146,201904
習志野店,1383,1127,256,1028,355,1015,368,130,114,135,127,140,128,123,110,144,114,118,34.692102928127774,201904
自由が丘店,1266,1026,240,940,326,930,336,124,121,116,104,121,117,113,104,106,131,109,34.46198830409357,201904
船橋店,1442,1210,232,1047,395,1059,383,119,116,149,147,124,127,139,132,134,140,115,34.72396694214876,201904
若葉店,1146,937,209,832,314,841,305,99,100,100,127,113,97,100,94,104,97,115,34.60192102454643,201904
茂原店,1329,1084,245,977,352,973,356,87,123,126,132,114,133,123,132,126,106,127,34.337638376383765,201904
茅ヶ崎店,881,748,133,655,226,650,231,85,83,77,86,95,58,88,77,87,72,73,34.754010695187176,201904
草加店,969,809,160,741,228,714,255,95,109,72,99,86,84,104,82,86,76,76,33.00123609394314,201904
荒川店,880,709,171,650,230,644,236,73,85,77,84,92,77,85,85,67,74,81,34.57404795486601,201904
荻窪店,1206,1003,203,894,312,886,320,117,100,138,101,114,112,108,102,101,105,108,19.85543369890329,201904
葛飾店,1122,924,198,832,290,823,299,93,76,110,104,118,124,106,109,80,106,96,34.08441558441559,201904
蒲田店,1009,819,190,718,291,741,268,100,101,87,87,89,78,95,106,85,84,97,34.876678876678874,201904
藤沢店,1154,960,194,856,298,842,312,104,119,88,101,114,136,103,105,117,84,83,34.121875,201904
行田店,971,804,167,707,264,713,258,79,100,79,97,105,83,68,88,93,98,81,34.8134328358209,201904
西多摩店,1528,1254,274,1124,404,1123,405,141,130,158,164,112,133,129,141,140,123,157,34.696172248803826,201904
西東京店,968,788,180,709,259,709,259,86,82,87,109,80,76,92,81,88,100,87,34.91624365482234,201904
西葛西店,793,659,134,603,190,580,213,64,78,69,69,77,74,70,89,72,62,69,35.45827010622155,201904
調布店,1380,1124,256,1021,359,1015,365,111,120,123,99,151,134,145,119,136,126,116,34.21263345195729,201904
谷中店,1505,1226,279,1083,422,1104,401,125,141,155,133,155,148,141,146,137,115,109,34.70962479608483,201904
赤坂店,1004,815,189,733,271,737,267,97,83,95,96,84,98,79,77,100,97,98,34.785276073619634,201904
赤羽店,1149,926,223,869,280,843,306,110,98,113,125,104,106,91,83,111,111,97,46.77429805615551,201904
越谷店,888,733,155,670,218,649,239,82,85,75,86,93,65,64,89,92,81,76,48.41200545702592,201904
足利店,793,639,154,586,207,580,213,70,67,73,74,61,76,72,88,66,80,66,33.497652582159624,201904
足柄上店,1205,973,232,890,315,884,321,111,103,125,105,112,116,122,89,101,112,109,33.993833504624874,201904
足立店,855,680,175,631,224,628,227,59,69,89,78,79,72,82,81,89,62,95,35.09705882352941,201904
逗子店,1065,867,198,784,281,782,283,111,83,86,102,101,102,91,102,100,91,96,34.4555940023068,201904
那珂店,1175,977,198,854,321,861,314,109,123,109,112,97,101,111,98,97,120,98,20.28045035823952,201904
都筑店,1001,820,181,749,252,733,268,80,117,90,99,63,80,103,93,99,84,93,33.96219512195122,201904
金沢店,1232,1017,215,925,307,902,330,100,114,105,116,92,117,125,122,122,101,118,19.731563421828913,201904
銀座店,968,776,192,692,276,710,258,78,105,84,84,97,92,67,78,98,89,96,34.56701030927835,201904
鎌倉店,964,787,177,703,261,708,256,96,96,83,88,84,77,84,92,86,92,86,34.45870393900889,201904
青山店,1318,1066,252,985,333,969,349,129,90,116,120,142,120,133,115,120,131,102,34.11632270168855,201904
青梅店,1236,988,248,910,326,907,329,114,90,96,120,112,107,135,126,97,124,115,34.62550607287449,201904
青葉店,1106,893,213,832,274,810,296,105,100,89,94,99,131,102,97,86,98,105,34.442329227323626,201904
館林店,1146,946,200,865,281,842,304,115,101,115,92,110,97,99,100,95,114,108,33.556025369978855,201904
駒沢店,1004,836,168,737,267,737,267,81,99,76,96,88,105,95,94,99,88,83,34.66387559808612,201904
駒込店,1445,1170,275,1057,388,1065,380,135,138,130,137,134,132,131,109,129,137,133,34.317094017094014,201904
高円寺店,1373,1097,276,990,383,1005,368,129,128,116,136,105,128,136,112,122,139,122,35.006381039197805,201904
高島平店,1209,982,227,893,316,886,323,141,108,101,93,116,106,112,99,101,109,123,34.66293279022403,201904
高崎店,1119,936,183,833,286,819,300,106,109,106,96,117,109,108,97,86,95,90,34.45619658119658,201904
高座店,1116,910,206,820,296,817,299,106,100,97,124,74,100,91,119,97,109,99,34.47582417582417,201904
高津店,1117,919,198,809,308,818,299,102,109,88,107,113,97,99,100,100,111,91,34.379760609357994,201904
高田馬場店,1054,876,178,814,240,774,280,92,83,78,91,88,103,109,113,105,93,99,35.96232876712329,201904
鴻巣店,1108,882,226,805,303,811,297,108,89,110,102,110,97,96,100,97,105,94,34.100907029478456,201904
鶴見店,1474,1226,248,1072,402,1081,393,124,146,125,136,133,148,120,123,133,147,139,34.202283849918445,201904
麻生店,1353,1093,260,1010,343,991,362,116,124,125,124,125,99,119,117,124,136,144,34.23421774931381,201904
あきる野店,1185,959,226,887,298,883,302,116,99,112,117,105,100,109,98,104,105,120,34.3910323253389,201905
さいたま南店,1553,1250,303,1161,392,1152,401,122,144,158,137,155,140,155,124,153,139,126,34.1824,201905
さいたま緑店,1070,867,203,802,268,796,274,98,86,94,97,109,106,89,101,86,102,102,34.074971164936564,201905
さいたま西店,1214,996,218,888,326,902,312,101,100,105,114,102,134,105,113,103,123,114,34.46586345381526,201905
つくば店,1305,1075,230,962,343,967,338,112,132,130,117,128,98,124,128,100,108,128,34.946976744186045,201905
三浦店,1186,983,203,879,307,879,307,117,117,104,114,107,112,87,98,104,117,109,34.029501525940994,201905
三鷹店,1550,1272,278,1150,400,1150,400,165,126,133,141,138,131,136,154,135,153,138,34.5188679245283,201905
上尾店,1369,1121,248,1019,350,1015,354,113,115,126,134,134,119,119,151,104,128,126,20.51293487957181,201905
上野店,1669,1371,298,1221,448,1237,432,169,149,152,151,137,156,149,141,175,122,168,34.23267687819111,201905
世田谷店,1587,1318,269,1155,432,1180,407,118,154,126,152,155,137,149,141,161,137,157,34.783763277693474,201905
中原店,1580,1290,290,1179,401,1177,403,150,153,133,151,131,154,133,146,138,140,151,34.652713178294576,201905
中店,1242,1019,223,893,349,921,321,133,96,119,114,102,116,104,112,117,130,99,35.11285574092247,201905
中野店,1188,945,243,856,332,881,307,130,100,129,104,107,101,104,101,97,111,104,34.22010582010582,201905
久喜店,1339,1109,230,1004,335,991,348,124,143,130,114,126,124,122,124,101,116,115,34.6546438232642,201905
九段店,1362,1111,251,1003,359,1009,353,120,140,128,113,122,123,129,121,126,113,127,34.88478847884789,201905
亀有店,1066,858,208,803,263,793,273,92,94,105,100,80,102,100,108,87,103,95,34.46153846153846,201905
五反田店,1186,965,221,884,302,882,304,98,125,108,100,110,98,101,118,125,109,94,34.54404145077719,201905
代々木店,1390,1107,283,1031,359,1030,360,134,125,113,139,116,119,130,126,123,116,149,34.65853658536585,201905
伊勢原店,1492,1210,282,1101,391,1110,382,137,125,118,136,140,129,134,150,167,119,137,34.304132231404964,201905
伊勢崎店,1644,1332,312,1209,435,1221,423,154,174,151,156,147,168,137,130,148,136,143,34.71096096096096,201905
佐倉店,912,748,164,656,256,676,236,79,99,82,81,87,86,75,88,80,84,71,34.93449197860963,201905
佐野店,1561,1278,283,1158,403,1160,401,132,141,151,150,132,132,143,152,140,151,137,34.79029733959312,201905
保土ケ谷店,1297,1058,239,944,353,961,336,109,113,119,117,100,139,127,127,108,119,119,34.63421550094518,201905
入間店,1188,955,233,875,313,886,302,119,100,99,119,113,108,117,104,106,102,101,34.966492146596856,201905
八千代店,1272,1056,216,936,336,942,330,116,107,94,130,110,116,129,129,106,109,126,34.496212121212125,201905
八潮店,1243,1004,239,888,355,918,325,116,108,103,115,113,119,114,125,126,102,102,33.745019920318725,201905
八王子店,1585,1288,297,1161,424,1179,406,141,136,144,134,158,151,136,152,145,148,140,33.596273291925456,201905
六本木店,1035,822,213,758,277,767,268,80,96,94,103,103,100,86,98,88,81,106,34.37712895377129,201905
前橋店,851,705,146,626,225,630,221,67,61,88,83,82,67,78,68,87,83,87,34.17304964539007,201905
北千住店,1022,826,196,759,263,754,268,91,98,92,77,86,104,101,104,92,74,103,33.7046004842615,201905
千葉中央店,1308,1076,232,941,367,968,340,109,126,116,131,95,133,115,123,102,126,132,34.68494423791822,201905
千葉緑店,1181,969,212,878,303,876,305,99,116,113,106,106,109,104,117,95,119,97,34.2280701754386,201905
南砂店,1300,1086,214,958,342,958,342,130,121,119,116,122,113,127,109,116,118,109,35.0,201905
南足柄店,1036,816,220,771,265,769,267,87,106,91,91,94,107,87,102,97,79,95,33.84681372549019,201905
厚木店,1487,1240,247,1104,383,1100,387,150,128,137,155,129,120,132,130,127,159,120,33.7233870967742,201905
取手店,1180,986,194,875,305,874,306,105,100,117,108,120,115,114,101,99,109,92,34.54361054766734,201905
向島店,1060,889,171,773,287,784,276,109,77,124,88,78,87,101,109,89,93,105,33.99212598425196,201905
君津店,1121,901,220,838,283,830,291,90,101,102,113,89,95,112,102,105,113,99,34.90899001109878,201905
和光店,1337,1099,238,1015,322,992,345,124,120,134,119,102,115,130,111,132,114,136,34.12374886260237,201905
品川店,1485,1214,271,1085,400,1100,385,119,147,136,132,142,134,120,137,122,141,155,34.17462932454695,201905
四街道店,837,665,172,616,221,623,214,69,69,71,75,90,72,68,77,79,83,84,34.536842105263155,201905
国分寺店,1013,851,162,770,243,749,264,80,93,94,98,96,81,93,103,106,82,87,34.608695652173914,201905
国立店,1394,1136,258,1029,365,1034,360,125,131,134,137,125,122,134,112,111,134,129,34.28521126760563,201905
坂戸店,1180,978,202,860,320,873,307,105,106,93,111,107,105,112,123,96,113,109,34.24437627811861,201905
墨田店,1005,809,196,753,252,745,260,96,85,94,103,82,89,92,108,87,90,79,34.3955500618047,201905
多摩店,1089,864,225,819,270,809,280,94,95,108,99,86,99,104,107,107,99,91,34.12037037037037,201905
大久保店,1070,837,233,763,307,795,275,100,84,100,99,102,104,91,95,97,110,88,34.56391875746714,201905
大井店,1215,955,260,873,342,901,314,102,102,110,127,121,121,99,121,97,100,115,34.59581151832461,201905
大和店,1362,1092,270,993,369,1012,350,118,121,118,116,133,141,126,114,114,132,129,34.184981684981686,201905
大塚店,1110,883,227,840,270,821,289,103,90,103,105,92,92,101,112,106,90,116,34.002265005662515,201905
大宮店,1363,1134,229,988,375,1010,353,127,106,139,125,122,110,133,127,106,133,135,34.4320987654321,201905
大森店,1420,1179,241,1021,399,1053,367,113,123,155,126,129,131,134,118,132,133,126,34.709923664122144,201905
大泉店,1211,967,244,919,292,899,312,100,108,114,98,111,107,132,98,98,125,120,34.43743536711479,201905
大田店,941,759,182,690,251,695,246,93,74,97,82,82,76,83,85,93,82,94,34.15810276679842,201905
太田店,1376,1105,271,1007,369,1020,356,134,123,149,125,119,115,108,127,117,124,135,34.310407239819014,201905
宇都宮店,1089,863,226,831,258,806,283,84,101,110,93,85,103,88,100,119,98,108,34.675550405561985,201905
守谷店,1192,980,212,888,304,888,304,95,99,115,114,125,110,114,92,115,97,116,33.81734693877551,201905
宮前店,726,595,131,551,175,538,188,79,59,77,60,81,53,52,65,63,70,67,34.265546218487394,201905
富岡店,1102,897,205,818,284,817,285,102,112,91,111,68,101,108,93,105,99,112,33.98996655518395,201905
富津店,1038,857,181,762,276,771,267,96,88,103,86,119,84,102,76,89,101,94,34.97199533255542,201905
富里店,1489,1200,289,1083,406,1104,385,136,124,137,120,136,124,141,133,144,150,144,34.9125,201905
小山店,1033,830,203,746,287,765,268,86,105,98,97,89,94,94,76,88,97,109,34.913253012048195,201905
小平店,1003,828,175,760,243,744,259,74,90,89,89,85,96,95,101,77,105,102,34.88405797101449,201905
小田原店,912,768,144,664,248,674,238,94,83,82,78,87,94,73,74,84,88,75,35.361979166666664,201905
小金井店,1090,894,196,815,275,811,279,96,109,87,94,109,99,97,107,98,100,94,35.03131991051454,201905
川口店,1116,920,196,811,305,829,287,101,104,94,107,107,103,107,77,117,97,102,34.30434782608695,201905
川崎多摩店,1118,914,204,836,282,827,291,99,118,95,92,106,93,92,95,115,100,113,33.5328227571116,201905
川崎店,1211,983,228,881,330,904,307,119,112,102,108,100,99,122,108,98,110,133,47.63987792472025,201905
川越店,1157,962,195,880,277,858,299,104,116,122,94,105,101,114,99,94,108,100,47.535343035343026,201905
巣鴨店,1525,1251,274,1132,393,1133,392,134,140,135,129,148,145,147,149,116,139,143,34.928057553956826,201905
市原店,1192,978,214,905,287,882,310,108,110,91,108,123,124,103,113,98,111,103,34.08588957055215,201905
市川店,1182,970,212,884,298,878,304,109,118,87,101,99,117,109,105,113,106,118,47.95360824742268,201905
平塚店,1188,955,233,865,323,883,305,123,97,119,115,115,119,109,108,94,94,95,35.414659685863874,201905
幸店,1432,1146,286,1085,347,1065,367,139,137,131,138,142,128,124,136,127,123,107,34.37085514834206,201905
府中店,1248,1006,242,909,339,924,324,104,114,122,95,125,131,112,110,108,107,120,34.57057654075547,201905
座間店,1365,1101,264,988,377,1013,352,123,119,131,115,130,124,134,120,117,116,136,34.6802906448683,201905
志木店,911,746,165,655,256,674,237,79,96,82,81,79,92,81,83,79,68,91,33.90348525469169,201905
恵比寿店,1036,842,194,777,259,772,264,91,88,92,78,109,91,106,107,88,93,93,20.54394299287411,201905
愛甲店,1060,848,212,784,276,785,275,102,94,76,97,85,107,96,92,102,107,102,34.98466981132077,201905
成城店,1362,1104,258,1030,332,1009,353,122,112,104,121,138,134,144,136,117,121,113,35.057065217391305,201905
成田店,876,717,159,651,225,648,228,78,80,72,74,80,77,70,85,85,101,74,34.73500697350069,201905
我孫子店,1119,915,204,824,295,831,288,102,116,97,107,90,100,111,96,96,97,107,20.3584699453552,201905
戸塚店,1553,1271,282,1154,399,1152,401,128,144,143,149,140,140,152,140,142,133,142,35.16837136113297,201905
戸田店,1539,1274,265,1130,409,1141,398,131,117,136,158,144,156,106,136,131,183,141,34.791993720565145,201905
所沢店,1184,978,206,871,313,877,307,107,108,115,103,97,104,111,113,103,117,106,34.129856850715754,201905
新宿店,1094,889,205,811,283,814,280,94,106,98,98,96,100,114,101,89,107,91,34.08661417322835,201905
新座店,1033,845,188,789,244,767,266,85,98,105,94,107,82,83,106,100,85,88,35.475739644970425,201905
日本橋店,1454,1199,255,1081,373,1081,373,133,132,128,126,136,137,129,111,135,136,151,34.76563803169308,201905
日立店,1300,1044,256,976,324,963,337,122,104,125,132,125,103,115,109,134,107,124,34.178160919540225,201905
日野店,1148,930,218,864,284,849,299,98,118,77,101,124,96,113,94,111,107,109,34.74301075268817,201905
旭店,1247,1019,228,942,305,922,325,115,104,109,110,131,110,121,119,110,108,110,34.419038272816486,201905
春日部店,1184,971,213,886,298,883,301,109,112,100,118,102,111,87,111,110,116,108,34.98661174047374,201905
昭島店,1216,988,228,886,330,902,314,93,97,119,107,108,119,120,112,129,103,109,34.736842105263165,201905
木更津店,1129,935,194,836,293,837,292,100,101,111,105,115,92,106,85,108,105,101,34.696256684491985,201905
本庄店,1183,956,227,899,284,876,307,116,116,116,99,114,112,107,103,100,92,108,34.19874476987448,201905
本郷店,762,620,142,583,179,563,199,77,66,59,66,66,69,60,76,65,78,80,47.91774193548387,201905
杉並店,1245,1015,230,916,329,927,318,109,127,117,111,123,124,105,92,117,107,113,34.533004926108376,201905
東中野店,1421,1170,251,1085,336,1055,366,129,128,140,154,123,126,121,128,117,132,123,34.93931623931624,201905
東久留米店,883,733,150,651,232,654,229,74,87,94,81,85,74,79,76,78,72,83,35.69167803547066,201905
東大和店,1090,911,179,786,304,809,281,95,109,101,93,87,90,102,106,117,94,96,34.542261251372125,201905
東尾久店,1218,972,246,914,304,904,314,102,97,107,111,128,99,120,104,110,116,124,34.27057613168724,201905
東村山店,1064,847,217,793,271,791,273,92,89,107,98,83,91,102,91,103,112,96,34.34474616292798,201905
東松山店,1336,1122,214,1006,330,996,340,115,135,125,130,134,104,124,119,130,115,105,33.79679144385027,201905
松戸店,1249,1023,226,944,305,929,320,107,111,103,119,111,133,104,124,128,96,113,33.52883675464321,201905
板橋店,1096,880,216,792,304,816,280,101,99,102,91,100,107,108,109,100,90,89,47.410227272727276,201905
柏店,1517,1251,266,1165,352,1123,394,154,121,132,139,124,138,132,112,154,151,160,35.456434852118306,201905
栃木店,1089,870,219,816,273,806,283,93,106,84,101,99,100,98,106,111,79,112,34.148275862068964,201905
栄店,1571,1284,287,1149,422,1169,402,149,135,130,157,145,136,131,122,157,150,159,20.217289719626173,201905
桐生店,1246,1020,226,935,311,928,318,105,111,124,122,107,103,119,118,117,110,110,33.99803921568628,201905
横浜南店,1437,1196,241,1055,382,1066,371,141,136,120,124,129,148,135,121,118,136,129,34.05602006688963,201905
横浜緑店,1312,1051,261,969,343,975,337,119,133,121,106,114,109,126,129,119,121,115,33.790675547098004,201905
横須賀店,1087,896,191,812,275,809,278,90,77,95,110,108,112,101,92,100,100,102,35.1171875,201905
武蔵村山店,1310,1070,240,975,335,971,339,119,120,146,95,113,119,118,125,113,115,127,34.7785046728972,201905
武蔵野店,1093,896,197,790,303,820,273,92,103,104,106,107,104,103,100,84,81,109,34.169642857142854,201905
水戸店,1401,1158,243,1027,374,1040,361,131,137,143,121,125,129,131,116,115,126,127,34.60708117443869,201905
江戸川店,1184,974,210,887,297,878,306,115,107,108,111,99,106,116,105,108,104,105,34.52258726899384,201905
江東店,1249,1019,230,918,331,922,327,116,125,117,116,123,108,119,100,98,107,120,34.130520117762515,201905
池尻店,1207,1001,206,889,318,895,312,103,121,95,104,113,117,115,104,113,110,112,34.81318681318681,201905
池袋店,1454,1198,256,1060,394,1076,378,143,134,138,125,121,154,122,132,122,145,118,34.98080133555926,201905
泉店,1493,1235,258,1102,391,1110,383,154,150,149,132,133,147,126,129,117,132,124,33.54493927125506,201905
流山店,1526,1256,270,1160,366,1131,395,130,137,136,136,138,140,138,157,126,160,128,33.51990445859873,201905
浅草店,1402,1151,251,1026,376,1039,363,141,113,121,136,121,128,140,136,124,121,121,34.060816681146825,201905
浦和店,1314,1053,261,1003,311,976,338,124,118,137,121,110,102,113,131,138,111,109,33.769230769230774,201905
浦安店,1338,1095,243,995,343,994,344,111,121,133,128,100,135,135,140,113,119,103,35.32146118721461,201905
海老名店,1196,976,220,894,302,887,309,122,110,101,104,114,127,102,99,112,110,95,35.14139344262295,201905
清瀬店,1059,867,192,753,306,784,275,109,94,97,112,83,86,89,107,96,99,87,35.036908881199544,201905
渋谷店,1158,935,223,858,300,859,299,112,105,99,99,114,114,109,102,87,109,108,33.57754010695187,201905
港北店,1032,864,168,751,281,764,268,97,80,96,102,88,81,82,97,88,128,93,20.297453703703702,201905
港南店,1247,991,256,930,317,922,325,107,126,112,116,114,95,130,107,118,108,114,34.353178607467214,201905
瀬谷店,1459,1193,266,1071,388,1086,373,135,132,135,138,147,131,143,130,123,113,132,34.21039396479463,201905
熊谷店,1126,926,200,856,270,838,288,117,94,102,103,97,112,102,100,99,93,107,34.874730021598275,201905
狛江店,1248,1006,242,938,310,926,322,107,109,116,100,113,127,121,120,117,95,123,33.97415506958251,201905
狭山店,1429,1179,250,1064,365,1060,369,121,104,121,125,131,142,134,127,146,135,143,34.991518235793045,201905
王子店,1158,987,171,868,290,856,302,112,93,110,113,109,114,104,86,93,106,118,20.714285714285715,201905
町田店,1344,1071,273,974,370,997,347,128,124,128,126,129,124,121,126,105,113,120,34.253968253968246,201905
白井店,1100,893,207,821,279,819,281,120,90,87,88,101,98,101,109,92,117,97,48.099664053751404,201905
目黒店,1214,1003,211,908,306,897,317,104,113,114,108,110,125,119,97,109,120,95,35.19740777666999,201905
相模原店,1489,1208,281,1138,351,1105,384,139,141,137,151,126,126,121,123,144,149,132,34.425496688741724,201905
石神井店,964,790,174,689,275,718,246,90,78,81,98,79,92,94,91,88,86,87,47.20632911392405,201905
磯子店,947,770,177,704,243,701,246,76,78,80,93,75,93,81,97,83,92,99,33.75584415584416,201905
神奈川店,1389,1150,239,1005,384,1033,356,136,134,130,117,126,109,139,126,117,125,130,34.57130434782609,201905
神田店,1455,1198,257,1052,403,1080,375,118,136,130,171,128,151,113,135,128,109,136,34.78964941569282,201905
福生店,1368,1130,238,1006,362,1020,348,97,126,131,154,95,136,146,104,129,117,133,34.90353982300885,201905
秦野店,1239,1009,230,924,315,915,324,96,94,105,112,126,127,118,115,103,126,117,35.12388503468781,201905
稲城店,976,793,183,744,232,725,251,95,93,90,82,98,70,91,81,86,93,97,47.843631778058004,201905
立川店,1311,1074,237,963,348,971,340,97,129,115,132,129,112,122,107,132,107,129,34.881750465549345,201905
綾瀬店,2703,2210,493,1990,713,2004,699,237,241,251,246,241,253,259,261,218,261,235,34.70814479638009,201905
練馬店,1428,1180,248,1047,381,1062,366,130,134,123,129,150,140,126,133,118,126,119,35.213559322033895,201905
羽村店,1394,1104,290,1041,353,1032,362,119,125,129,131,131,110,126,135,131,129,128,20.36503623188406,201905
羽生店,1341,1097,244,1000,341,992,349,129,127,117,114,132,125,118,120,113,140,106,33.8714676390155,201905
習志野店,1432,1149,283,1072,360,1064,368,123,117,150,133,138,123,126,131,122,124,145,35.40818102697997,201905
自由が丘店,1315,1053,262,981,334,979,336,121,109,138,125,131,126,114,101,117,110,123,34.49477682811016,201905
船橋店,1490,1235,255,1107,383,1104,386,138,147,104,126,151,163,122,140,128,152,119,34.22186234817813,201905
若葉店,1175,956,219,866,309,869,306,110,114,100,92,102,103,112,123,110,110,99,34.23012552301255,201905
茂原店,1361,1106,255,997,364,1008,353,127,128,116,129,132,127,122,110,121,122,127,35.51808318264015,201905
茅ヶ崎店,913,751,162,643,270,677,236,79,79,83,92,75,91,87,95,59,73,100,33.82556591211718,201905
草加店,1006,816,190,738,268,744,262,103,87,84,85,97,92,97,101,85,85,90,34.127450980392155,201905
荒川店,910,736,174,691,219,672,238,93,71,106,96,83,86,65,75,77,81,77,34.95108695652174,201905
荻窪店,1241,1010,231,917,324,922,319,108,113,120,107,114,118,110,108,118,116,109,19.836633663366328,201905
葛飾店,1159,938,221,882,277,861,298,88,98,126,113,91,111,110,113,101,100,108,34.11940298507463,201905
蒲田店,1034,886,148,761,273,766,268,77,115,80,114,97,103,73,92,100,89,94,33.37471783295711,201905
藤沢店,1189,984,205,890,299,881,308,119,98,98,105,106,111,135,99,108,100,110,34.46239837398374,201905
行田店,1007,815,192,723,284,748,259,85,86,85,88,98,99,88,97,88,92,101,34.122699386503065,201905
西多摩店,1581,1281,300,1170,411,1178,403,153,149,148,135,156,134,137,151,139,129,150,34.43091334894613,201905
西東京店,1006,830,176,744,262,744,262,90,87,106,70,87,81,89,98,99,97,102,34.257831325301204,201905
西葛西店,813,659,154,603,210,601,212,75,71,75,79,70,70,74,75,75,72,77,34.71775417298938,201905
調布店,1431,1188,243,1058,373,1064,367,120,135,108,133,129,133,141,143,141,121,127,33.996632996633004,201905
谷中店,1552,1268,284,1121,431,1151,401,101,121,162,153,148,161,130,138,138,164,136,33.69479495268139,201905
赤坂店,1038,844,194,764,274,768,270,87,93,92,104,86,104,87,100,103,93,89,34.02369668246445,201905
赤羽店,1188,962,226,895,293,880,308,107,109,102,114,104,117,100,117,100,118,100,47.406444906444904,201905
越谷店,915,737,178,672,243,681,234,98,64,81,84,87,71,78,86,80,71,115,48.22523744911806,201905
足利店,824,669,155,597,227,612,212,84,66,84,65,74,68,74,67,73,86,83,34.666666666666664,201905
足柄上店,1249,1031,218,911,338,929,320,103,118,100,122,125,114,124,114,121,107,101,34.05722599418041,201905
足立店,874,699,175,649,225,648,226,79,72,80,88,68,88,92,91,76,64,76,33.17882689556509,201905
逗子店,1090,896,194,832,258,808,282,103,77,90,114,97,116,95,102,95,102,99,34.5234375,201905
那珂店,1213,994,219,899,314,898,315,128,95,106,117,105,111,103,124,91,104,129,20.100603621730386,201905
都筑店,1032,845,187,749,283,766,266,84,100,90,94,82,88,92,98,119,98,87,34.16213017751479,201905
金沢店,1271,1036,235,944,327,942,329,122,109,120,124,120,116,117,86,122,118,117,20.41988416988417,201905
銀座店,1001,830,171,748,253,744,257,99,78,92,92,93,86,102,96,81,82,100,33.90120481927711,201905
鎌倉店,997,814,183,730,267,739,258,88,91,87,92,90,91,96,92,80,87,103,34.87960687960688,201905
青山店,1360,1107,253,1013,347,1010,350,113,132,142,105,106,144,102,125,127,142,122,34.55374887082204,201905
青梅店,1277,1029,248,927,350,947,330,115,104,133,100,121,112,112,128,108,128,116,34.62390670553936,201905
青葉店,1159,958,201,879,280,858,301,98,105,112,108,111,131,84,107,113,100,90,34.38622129436326,201905
館林店,1184,967,217,886,298,882,302,117,95,103,100,102,114,109,124,93,110,117,33.4870734229576,201905
駒沢店,1031,851,180,779,252,763,268,87,93,90,91,97,70,94,88,109,96,116,34.928319623971795,201905
駒込店,1492,1194,298,1115,377,1106,386,131,121,142,135,133,158,118,147,145,144,118,34.36348408710218,201905
高円寺店,1422,1208,214,1061,361,1054,368,129,131,120,143,129,126,131,131,133,135,114,32.852649006622514,201905
高島平店,1248,999,249,886,362,927,321,115,122,123,103,114,104,107,124,106,117,113,34.327327327327325,201905
高崎店,1164,933,231,882,282,862,302,111,108,84,97,96,103,119,107,104,103,132,34.748124330117896,201905
高座店,1149,963,186,846,303,852,297,102,95,79,101,108,131,107,107,97,117,105,34.76635514018692,201905
高津店,1151,975,176,866,285,854,297,90,92,110,104,105,109,113,106,105,110,107,34.72,201905
高田馬場店,1090,886,204,817,273,807,283,107,108,90,91,105,91,96,102,102,105,93,34.78893905191874,201905
鴻巣店,1149,936,213,854,295,853,296,103,98,105,114,98,101,108,101,116,113,92,34.4284188034188,201905
鶴見店,1520,1214,306,1102,418,1127,393,143,126,135,141,142,138,154,137,138,132,134,34.397034596375626,201905
麻生店,1398,1150,248,1046,352,1034,364,112,122,131,128,116,129,135,132,135,126,132,34.19391304347826,201905
あきる野店,1148,939,209,869,279,764,384,102,98,106,108,108,100,95,106,106,113,106,35.02129925452609,201906
さいたま南店,1501,1235,266,1126,375,999,502,161,134,132,120,121,142,136,152,143,130,130,34.14817813765182,201906
さいたま緑店,1034,847,187,760,274,689,345,111,78,80,92,109,97,89,94,87,95,102,34.044864226682414,201906
さいたま西店,1180,965,215,886,294,784,396,100,127,116,89,105,98,107,112,99,104,123,33.612435233160625,201906
つくば店,1274,1053,221,951,323,849,425,116,106,117,112,101,122,122,124,124,103,127,34.45584045584046,201906
三浦店,1149,937,212,859,290,766,383,110,97,113,107,101,112,92,100,99,97,121,34.70864461045891,201906
三鷹店,1504,1222,282,1119,385,1000,504,133,127,144,145,116,145,152,129,145,129,139,34.12274959083469,201906
上尾店,1321,1082,239,971,350,878,443,122,121,99,139,136,109,115,112,113,133,122,20.11275415896488,201906
上野店,1625,1361,264,1191,434,1087,538,144,154,138,161,127,139,148,157,155,151,151,34.7391623806025,201906
世田谷店,1534,1255,279,1159,375,1018,516,145,139,147,131,142,139,137,137,137,116,164,34.2796812749004,201906
中原店,1529,1243,286,1115,414,1020,509,119,137,138,147,133,132,143,145,150,143,142,34.56958970233307,201906
中店,1201,987,214,893,308,798,403,105,118,99,109,116,106,106,116,117,110,99,34.559270516717326,201906
中野店,1148,940,208,844,304,765,383,90,108,121,117,103,105,103,99,91,112,99,34.72659574468085,201906
久喜店,1290,1063,227,969,321,860,430,125,122,125,138,110,119,99,103,105,110,134,34.74223894637817,201906
九段店,1314,1071,243,975,339,876,438,112,138,138,111,123,99,126,120,117,123,107,34.86087768440709,201906
亀有店,1030,848,182,798,232,687,343,96,101,84,80,120,75,89,94,82,105,104,34.364386792452834,201906
五反田店,1157,933,224,850,307,773,384,88,116,82,130,104,125,89,115,90,104,114,33.30117899249732,201906
代々木店,1351,1107,244,987,364,898,453,126,123,126,129,126,117,118,128,122,103,133,33.320686540198736,201906
伊勢原店,1437,1187,250,1054,383,962,475,130,145,133,131,129,122,127,133,125,135,127,35.244313395113736,201906
伊勢崎店,1588,1295,293,1166,422,1061,527,124,143,163,127,151,144,128,156,158,150,144,35.04633204633205,201906
佐倉店,886,715,171,656,230,589,297,76,92,84,79,75,72,79,97,86,66,80,35.22797202797203,201906
佐野店,1491,1221,270,1124,367,997,494,142,137,135,143,139,120,136,144,119,146,130,34.116298116298125,201906
保土ケ谷店,1253,1033,220,944,309,838,415,112,119,112,124,121,113,116,119,86,116,115,34.8189738625363,201906
入間店,1146,936,210,845,301,762,384,108,98,81,109,129,101,103,87,111,107,112,33.65064102564103,201906
八千代店,1231,999,232,877,354,820,411,106,113,112,107,115,109,113,117,119,106,114,34.755755755755764,201906
八潮店,1205,968,237,898,307,801,404,115,95,110,130,121,110,101,109,101,117,96,34.820247933884296,201906
八王子店,1541,1275,266,1132,409,1027,514,131,157,147,143,113,138,136,148,133,147,148,33.901960784313715,201906
六本木店,997,826,171,725,272,662,335,89,94,79,91,81,84,88,99,96,95,101,34.29782082324455,201906
前橋店,821,669,152,606,215,551,270,80,72,83,76,74,65,73,82,59,81,76,34.521674140508225,201906
北千住店,1002,815,187,731,271,669,333,100,82,82,94,76,91,82,104,100,97,94,34.89447852760736,201906
千葉中央店,1262,1010,252,976,286,840,422,101,141,109,92,112,108,116,112,126,126,119,34.661386138613864,201906
千葉緑店,1145,918,227,863,282,763,382,110,114,113,85,102,101,100,99,118,95,108,34.650326797385624,201906
南砂店,1266,1048,218,929,337,841,425,115,105,120,131,107,100,115,124,124,126,99,34.275763358778626,201906
南足柄店,994,810,184,760,234,663,331,89,90,100,87,84,88,89,80,79,107,101,33.84691358024691,201906
厚木店,1428,1192,236,1059,369,954,474,130,122,135,135,131,138,146,124,128,123,116,33.47651006711409,201906
取手店,1148,944,204,826,322,765,383,103,102,100,110,105,98,102,103,109,107,109,35.219279661016955,201906
向島店,1023,834,189,750,273,685,338,96,106,91,80,94,86,89,114,85,94,88,34.134292565947234,201906
君津店,1096,896,200,783,313,728,368,107,89,96,105,84,104,93,114,116,105,83,34.075892857142854,201906
和光店,1302,1073,229,995,307,866,436,124,133,121,123,129,106,109,117,114,103,123,35.18546132339236,201906
品川店,1451,1163,288,1060,391,972,479,154,137,138,122,140,134,124,103,140,116,143,34.58125537403267,201906
四街道店,818,651,167,588,230,545,273,77,81,65,69,75,75,72,81,72,84,67,34.37019969278034,201906
国分寺店,971,788,183,727,244,647,324,91,97,105,79,84,81,79,86,77,109,83,34.6256345177665,201906
国立店,1342,1083,259,977,365,897,445,140,118,115,110,123,119,130,120,119,112,136,34.4404432132964,201906
坂戸店,1141,939,202,867,274,759,382,91,108,108,115,90,111,108,106,85,107,112,35.980830670926515,201906
墨田店,976,798,178,736,240,652,324,77,79,80,83,95,90,77,96,89,118,92,34.19924812030075,201906
多摩店,1051,863,188,779,272,699,352,91,98,84,82,82,100,115,102,97,102,98,34.863267670915405,201906
大久保店,1028,861,167,765,263,687,341,82,100,91,77,95,98,98,102,92,97,96,34.771196283391404,201906
大井店,1179,960,219,866,313,785,394,104,115,100,116,92,101,107,123,121,105,95,35.171875,201906
大和店,1324,1074,250,958,366,882,442,119,138,101,112,128,120,101,127,118,137,123,34.52141527001862,201906
大塚店,1089,869,220,822,267,728,361,87,108,111,93,90,115,101,90,85,101,108,35.1668584579977,201906
大宮店,1324,1080,244,972,352,883,441,125,111,123,135,125,116,113,123,128,103,122,34.693518518518516,201906
大森店,1383,1115,268,1003,380,923,460,127,120,130,104,135,112,135,130,124,139,127,33.73094170403587,201906
大泉店,1159,959,200,847,312,775,384,99,106,127,104,108,85,105,95,108,111,111,35.21480709071949,201906
大田店,906,741,165,672,234,600,306,85,78,78,78,79,85,90,78,81,86,88,33.875843454790825,201906
太田店,1320,1064,256,975,345,883,437,136,123,106,117,131,114,143,116,111,112,111,34.005639097744364,201906
宇都宮店,1057,867,190,791,266,704,353,94,101,98,79,106,82,96,97,105,106,93,34.351787773933104,201906
守谷店,1142,919,223,856,286,762,380,96,98,118,106,112,104,121,74,98,107,108,34.464635473340586,201906
宮前店,702,581,121,519,183,469,233,77,57,51,74,62,71,64,56,70,68,52,32.987951807228924,201906
富岡店,1058,877,181,779,279,706,352,96,90,102,90,97,95,90,93,105,100,100,34.48574686431015,201906
富津店,1005,830,175,746,259,668,337,109,73,106,72,99,88,93,99,87,93,86,34.74457831325301,201906
富里店,1439,1177,262,1058,381,965,474,136,126,137,126,120,120,121,127,151,137,138,34.949872557349195,201906
小山店,999,819,180,741,258,667,332,80,101,101,95,95,84,79,87,99,94,84,33.96214896214896,201906
小平店,970,794,176,719,251,645,325,73,97,97,94,94,77,98,95,95,71,79,34.559193954659946,201906
小田原店,877,735,142,613,264,586,291,80,97,85,78,93,64,74,79,76,80,71,33.99455782312925,201906
小金井店,1059,867,192,788,271,706,353,111,101,97,86,95,90,104,90,91,103,91,34.491349480968864,201906
川口店,1091,890,201,806,285,728,363,114,100,113,97,83,93,99,105,88,114,85,34.97977528089888,201906
川崎多摩店,1082,888,194,819,263,725,357,94,101,110,101,99,94,85,105,103,95,95,34.921171171171174,201906
川崎店,1166,963,203,874,292,777,389,97,98,88,118,107,111,114,112,104,111,106,48.23260643821392,201906
川越店,1117,915,202,809,308,745,372,90,97,104,101,102,98,103,118,104,98,102,48.10382513661202,201906
巣鴨店,1462,1178,284,1090,372,972,490,138,103,107,135,141,158,135,131,137,136,141,34.782682512733444,201906
市原店,1149,928,221,856,293,766,383,99,99,83,112,99,99,104,123,107,112,112,35.19612068965517,201906
市川店,1146,950,196,883,263,768,378,98,96,97,104,100,126,109,122,105,100,89,48.07578947368422,201906
平塚店,1152,932,220,845,307,766,386,106,97,114,110,102,100,97,122,112,112,80,34.90343347639485,201906
幸店,1395,1119,276,1061,334,930,465,153,120,135,120,138,101,139,108,129,125,127,34.343163538873995,201906
府中店,1204,979,225,895,309,803,401,115,104,118,102,113,119,104,102,103,115,109,34.27170582226762,201906
座間店,1325,1097,228,980,345,886,439,112,121,141,130,117,137,114,110,115,125,103,34.4257064721969,201906
志木店,879,719,160,653,226,589,290,73,70,91,87,80,84,93,76,80,73,72,34.87760778859527,201906
恵比寿店,999,833,166,733,266,666,333,96,86,92,94,93,73,93,99,93,93,87,20.73469387755102,201906
愛甲店,1024,848,176,745,279,680,344,73,93,94,100,78,83,90,114,87,102,110,33.827830188679236,201906
成城店,1335,1085,250,970,365,892,443,127,125,121,124,131,132,112,126,109,118,110,34.67188940092166,201906
成田店,848,686,162,621,227,565,283,76,87,60,93,79,80,84,66,75,82,66,33.877551020408156,201906
我孫子店,1095,898,197,821,274,731,364,94,109,94,107,93,97,110,97,91,100,103,20.365256124721604,201906
戸塚店,1500,1248,252,1121,379,1002,498,148,135,137,141,131,122,142,140,118,135,151,34.314903846153854,201906
戸田店,1507,1217,290,1102,405,1009,498,133,131,139,139,131,143,144,137,144,127,139,34.24075595727198,201906
所沢店,1150,956,194,878,272,765,385,102,98,97,122,113,111,93,117,104,92,101,34.6663179916318,201906
新宿店,1066,865,201,787,279,711,355,122,98,99,97,99,84,78,98,103,91,97,35.14913294797688,201906
新座店,996,808,188,743,253,664,332,87,73,94,75,100,89,95,107,81,103,92,35.54579207920792,201906
日本橋店,1415,1162,253,1040,375,943,472,121,116,128,118,144,116,140,120,132,151,129,35.0,201906
日立店,1271,1031,240,964,307,848,423,132,124,123,109,121,103,107,104,137,122,89,34.649854510184284,201906
日野店,1120,909,211,847,273,747,373,82,95,89,101,103,98,110,102,126,95,119,34.478547854785475,201906
旭店,1208,978,230,907,301,805,403,109,119,109,109,102,107,115,102,110,111,115,35.35276073619632,201906
春日部店,1152,969,183,843,309,770,382,112,100,94,122,108,111,98,107,93,108,99,34.62332301341589,201906
昭島店,1165,933,232,863,302,773,392,117,106,101,104,112,105,100,108,117,99,96,34.69346195069668,201906
木更津店,1087,891,196,807,280,726,361,92,97,108,91,94,86,92,111,119,94,103,34.849607182940524,201906
本庄店,1149,931,218,841,308,768,381,115,94,98,103,106,111,103,110,102,110,97,35.1203007518797,201906
本郷店,734,592,142,557,177,490,244,57,66,62,52,64,70,82,66,68,77,70,46.625,201906
杉並店,1213,991,222,882,331,807,406,121,110,112,115,111,116,109,95,103,120,101,34.45913218970737,201906
東中野店,1388,1108,280,1038,350,927,461,123,108,122,112,118,151,125,135,131,133,130,34.058664259927795,201906
東久留米店,853,700,153,650,203,568,285,80,66,81,79,79,84,94,68,75,74,73,34.59571428571429,201906
東大和店,1053,855,198,762,291,699,354,104,102,102,84,101,82,92,76,102,101,107,34.930994152046786,201906
東尾久店,1171,958,213,848,323,777,394,108,111,102,115,108,124,104,119,89,95,96,34.13256784968685,201906
東村山店,1026,836,190,747,279,687,339,92,96,86,94,85,88,108,102,92,94,89,35.02511961722488,201906
東松山店,1298,1085,213,991,307,866,432,124,125,119,103,124,100,108,115,129,128,123,34.836866359447015,201906
松戸店,1208,977,231,861,347,807,401,105,112,133,98,111,103,105,103,113,104,121,33.81166837256909,201906
板橋店,1057,870,187,797,260,703,354,96,91,93,89,114,107,78,85,109,99,96,48.32183908045979,201906
柏店,1465,1190,275,1087,378,978,487,107,138,142,152,129,118,127,145,139,131,137,34.65126050420168,201906
栃木店,1061,885,176,798,263,711,350,99,96,104,98,100,97,89,97,103,94,84,34.371751412429376,201906
栄店,1536,1219,317,1125,411,1023,513,160,140,137,139,146,126,135,130,144,122,157,20.339622641509433,201906
桐生店,1211,976,235,913,298,804,407,130,107,108,100,108,96,107,115,115,118,107,35.33094262295082,201906
横浜南店,1380,1115,265,1020,360,923,457,133,122,119,139,140,110,115,119,136,124,123,35.333632286995524,201906
横浜緑店,1268,1044,224,953,315,850,418,135,109,96,119,105,125,119,115,118,120,107,33.928160919540225,201906
横須賀店,1051,860,191,750,301,700,351,92,102,88,89,90,105,82,113,96,102,92,34.931395348837206,201906
武蔵村山店,1266,1037,229,925,341,843,423,116,123,105,132,107,109,136,106,109,113,110,34.650916104146575,201906
武蔵野店,1056,861,195,785,271,702,354,88,96,96,90,91,96,86,105,83,107,118,35.0267131242741,201906
水戸店,1350,1111,239,994,356,899,451,114,106,135,133,128,129,109,122,118,112,144,34.678667866786675,201906
江戸川店,1151,946,205,851,300,764,387,98,107,114,109,122,96,103,98,98,110,96,35.561310782241016,201906
江東店,1208,1001,207,907,301,806,402,119,115,122,111,123,104,113,115,95,75,116,34.81518481518481,201906
池尻店,1173,947,226,862,311,780,393,95,114,102,91,119,112,107,106,118,111,98,34.04751847940866,201906
池袋店,1405,1142,263,1058,347,931,474,113,142,122,155,148,131,94,129,123,126,122,34.418563922942205,201906
泉店,1439,1188,251,1081,358,958,481,155,126,110,135,143,128,127,136,127,120,132,34.12205387205388,201906
流山店,1477,1188,289,1097,380,986,491,119,159,132,135,135,131,121,140,128,150,127,35.63299663299663,201906
浅草店,1352,1103,249,1016,336,902,450,125,105,120,104,121,143,135,135,124,120,120,34.22665457842248,201906
浦和店,1258,1010,248,926,332,837,421,131,118,120,115,115,96,114,115,111,117,106,34.19009900990099,201906
浦安店,1286,1042,244,943,343,857,429,114,111,108,117,124,113,121,125,116,112,125,35.08349328214971,201906
海老名店,1149,923,226,866,283,767,382,128,96,113,105,103,104,109,109,93,81,108,34.46045503791983,201906
清瀬店,1031,856,175,772,259,690,341,91,101,80,108,94,81,93,106,90,96,91,34.351635514018696,201906
渋谷店,1115,928,187,816,299,744,371,99,108,92,117,103,104,106,98,104,85,99,34.66702586206897,201906
港北店,996,827,169,751,245,667,329,85,90,80,97,109,82,85,91,96,94,87,20.610640870616685,201906
港南店,1199,991,208,881,318,795,404,117,109,110,111,117,99,123,102,95,109,107,34.524722502522714,201906
瀬谷店,1416,1136,280,1028,388,940,476,116,138,117,113,123,150,105,154,134,138,128,33.57218309859155,201906
熊谷店,1086,896,190,821,265,725,361,90,101,102,112,105,99,106,86,93,93,99,34.083705357142854,201906
狛江店,1206,998,208,929,277,802,404,105,95,99,111,134,92,92,111,129,125,113,33.78256513026052,201906
狭山店,1379,1101,278,1027,352,922,457,120,114,136,116,122,145,120,125,133,115,133,34.305177111716624,201906
王子店,1110,899,211,831,279,736,374,95,102,89,97,102,119,91,102,100,114,99,20.85650723025584,201906
町田店,1302,1048,254,965,337,864,438,127,120,120,106,115,108,121,136,122,123,104,34.77003816793893,201906
白井店,1053,862,191,787,266,701,352,89,90,100,111,98,97,87,99,88,98,96,47.09628770301625,201906
目黒店,1177,961,216,887,290,787,390,102,124,133,100,94,111,108,95,95,111,104,34.270551508844946,201906
相模原店,1423,1154,269,1046,377,948,475,134,142,138,114,126,136,132,116,129,116,140,34.592720970537265,201906
石神井店,942,766,176,693,249,624,318,90,81,76,105,82,77,95,87,87,83,79,47.494778067885115,201906
磯子店,917,763,154,678,239,611,306,71,84,72,85,67,92,93,93,87,88,85,34.285714285714285,201906
神奈川店,1352,1097,255,998,354,900,452,116,121,133,131,124,120,122,122,116,120,127,35.57793983591613,201906
神田店,1408,1160,248,1055,353,942,466,149,122,112,131,124,128,134,130,122,128,128,34.2646551724138,201906
福生店,1322,1063,259,989,333,877,445,110,124,114,112,106,107,127,127,121,137,137,34.023518344308556,201906
秦野店,1209,1002,207,893,316,806,403,102,105,115,110,116,131,114,90,116,109,101,34.70858283433134,201906
稲城店,943,801,142,706,237,626,317,90,78,84,89,100,78,85,85,93,80,81,48.987515605493144,201906
立川店,1265,1018,247,937,328,842,423,114,132,109,111,114,132,132,93,102,126,100,34.44400785854617,201906
綾瀬店,2623,2143,480,1940,683,1750,873,236,233,250,246,223,246,252,225,244,224,244,34.55156322911806,201906
練馬店,1384,1101,283,1015,369,923,461,141,131,141,134,121,132,116,110,124,124,110,33.932788374205266,201906
羽村店,1347,1106,241,1001,346,896,451,127,112,123,104,129,123,123,132,128,121,125,20.529837251356238,201906
羽生店,1298,1035,263,936,362,866,432,119,136,102,121,112,134,101,136,99,121,117,34.616425120772945,201906
習志野店,1386,1115,271,1005,381,921,465,134,120,136,155,107,121,101,136,143,119,114,35.54618834080718,201906
自由が丘店,1266,1036,230,931,335,847,419,113,95,115,121,131,112,104,118,111,117,129,33.981660231660236,201906
船橋店,1443,1196,247,1063,380,961,482,157,133,116,128,122,132,132,128,128,151,116,33.98913043478261,201906
若葉店,1145,915,230,845,300,764,381,90,100,120,103,71,107,119,116,84,126,109,34.3344262295082,201906
茂原店,1321,1097,224,984,337,881,440,111,121,117,99,108,117,137,115,121,137,138,34.16681859617137,201906
茅ヶ崎店,887,722,165,679,208,591,296,88,68,79,78,84,70,79,72,89,92,88,33.66343490304709,201906
草加店,973,793,180,738,235,648,325,97,94,87,87,94,81,83,82,103,75,90,34.90542244640605,201906
荒川店,884,713,171,667,217,587,297,80,72,73,82,75,97,78,95,81,81,70,34.78962131837307,201906
荻窪店,1206,999,207,889,317,804,402,107,95,103,110,127,110,112,107,111,112,112,20.444444444444443,201906
葛飾店,1116,928,188,834,282,740,376,121,105,99,95,84,103,112,99,93,95,110,34.28125,201906
蒲田店,997,804,193,719,278,663,334,85,108,98,96,76,87,83,110,95,83,76,34.6728855721393,201906
藤沢店,1153,950,203,851,302,771,382,113,101,126,102,91,97,95,104,110,109,105,34.61157894736842,201906
行田店,974,798,176,720,254,654,320,89,94,94,85,94,88,84,90,95,75,86,34.087719298245624,201906
西多摩店,1528,1256,272,1141,387,1015,513,129,112,136,135,158,140,153,153,145,140,127,33.86305732484077,201906
西東京店,976,816,160,723,253,648,328,90,100,87,89,93,90,76,85,84,92,90,33.91544117647059,201906
西葛西店,790,646,144,574,216,526,264,86,66,67,68,67,84,76,67,61,80,68,34.57430340557276,201906
調布店,1378,1115,263,1002,376,917,461,134,118,143,132,118,114,123,113,133,129,121,34.49865470852018,201906
谷中店,1502,1207,295,1133,369,1003,499,134,132,137,144,119,134,141,156,144,123,138,34.09444904722452,201906
赤坂店,1003,814,189,748,255,670,333,88,96,75,106,96,94,72,100,80,88,108,34.67690417690417,201906
赤羽店,1151,927,224,844,307,769,382,116,116,109,86,109,113,98,100,101,92,111,47.509169363538284,201906
越谷店,888,728,160,638,250,593,295,79,81,75,81,78,87,70,92,82,91,72,48.91346153846154,201906
足利店,790,646,144,572,218,526,264,80,79,76,65,51,74,80,75,59,72,79,34.3374613003096,201906
足柄上店,1214,988,226,889,325,808,406,97,103,127,117,96,111,125,107,112,101,118,34.07894736842105,201906
足立店,850,676,174,610,240,567,283,79,85,76,76,81,67,79,82,80,80,65,34.91568047337278,201906
逗子店,1058,865,193,778,280,707,351,100,98,93,80,109,99,104,102,86,89,98,35.0393063583815,201906
那珂店,1179,940,239,863,316,788,391,129,87,120,99,115,108,101,88,111,94,127,19.842553191489362,201906
都筑店,995,800,195,721,274,666,329,84,97,98,97,96,95,93,79,79,89,88,34.645,201906
金沢店,1239,1009,230,941,298,826,413,128,119,111,120,125,106,93,104,106,112,115,19.841427155599607,201906
銀座店,966,782,184,698,268,642,324,92,110,100,77,72,97,75,91,84,79,89,35.584398976982094,201906
鎌倉店,977,801,176,738,239,651,326,81,90,93,88,89,98,85,98,94,87,74,33.935081148564294,201906
青山店,1327,1087,240,965,362,881,446,133,127,123,101,122,134,103,116,121,117,130,34.632014719411224,201906
青梅店,1236,1002,234,896,340,819,417,116,107,115,102,108,107,119,118,122,106,116,35.330339321357286,201906
青葉店,1116,888,228,829,287,744,372,115,106,109,96,105,85,104,111,112,98,75,34.54054054054054,201906
館林店,1144,927,217,854,290,765,379,99,119,87,133,106,90,114,104,103,101,88,34.89967637540453,201906
駒沢店,999,826,173,760,239,666,333,87,89,97,88,106,89,87,76,96,99,85,34.32929782082324,201906
駒込店,1447,1185,262,1091,356,962,485,123,136,134,132,129,144,132,132,144,122,119,34.59915611814346,201906
高円寺店,1375,1120,255,1023,352,920,455,119,118,112,137,150,101,153,116,109,123,137,34.24196428571429,201906
高島平店,1210,985,225,904,306,806,404,110,130,114,109,114,100,126,98,90,104,115,35.02335025380711,201906
高崎店,1122,933,189,823,299,751,371,114,88,106,90,135,108,84,114,86,92,105,34.37084673097535,201906
高座店,1110,905,205,813,297,741,369,92,92,96,85,121,97,117,114,103,96,97,33.50276243093923,201906
高津店,1104,907,197,815,289,740,364,93,118,96,102,102,105,95,90,101,109,93,34.574421168687984,201906
高田馬場店,1055,878,177,782,273,702,353,89,112,111,100,82,100,92,92,94,81,102,34.633257403189056,201906
鴻巣店,1114,900,214,829,285,740,374,102,108,109,114,85,102,95,104,105,96,94,34.712222222222216,201906
鶴見店,1470,1176,294,1103,367,978,492,139,131,120,137,151,146,129,136,134,121,126,35.43027210884354,201906
麻生店,1352,1085,267,1017,335,903,449,118,111,121,119,111,137,122,111,138,131,133,34.45069124423963,201906
あきる野店,1190,988,202,898,292,882,308,120,112,100,102,114,110,113,87,111,109,112,33.84311740890689,201907
さいたま南店,1551,1241,310,1140,411,1154,397,142,135,143,157,134,128,151,147,143,135,136,35.37792103142628,201907
さいたま緑店,1069,907,162,784,285,796,273,109,85,107,91,102,93,107,100,89,88,98,33.99007717750827,201907
さいたま西店,1217,1010,207,917,300,902,315,139,103,112,99,100,111,115,119,114,115,90,35.13663366336634,201907
つくば店,1298,1071,227,936,362,961,337,130,116,116,113,124,101,117,121,112,127,121,34.85434173669468,201907
三浦店,1180,959,221,900,280,877,303,114,118,124,126,108,95,99,97,104,93,102,34.59228362877998,201907
三鷹店,1545,1251,294,1176,369,1148,397,109,140,123,137,161,144,138,155,136,169,133,35.0431654676259,201907
上尾店,1367,1105,262,1024,343,1016,351,134,131,121,122,131,116,114,126,108,137,127,19.877828054298643,201907
上野店,1675,1371,304,1226,449,1243,432,128,157,145,160,161,148,160,130,163,156,167,34.51714077315828,201907
世田谷店,1583,1292,291,1178,405,1181,402,141,161,143,161,137,164,149,140,135,123,129,34.30572755417957,201907
中原店,1591,1294,297,1185,406,1180,411,139,139,147,166,143,138,142,152,140,126,159,34.63369397217929,201907
中店,1244,1011,233,918,326,929,315,107,146,114,111,117,98,111,112,105,110,113,34.28486646884273,201907
中野店,1180,975,205,879,301,881,299,99,116,102,118,103,95,116,95,118,106,112,35.033846153846156,201907
久喜店,1335,1120,215,985,350,990,345,124,118,120,123,122,135,123,115,117,120,118,34.5875,201907
九段店,1361,1121,240,987,374,1009,352,131,119,112,139,134,136,113,126,126,120,105,34.92060660124889,201907
亀有店,1066,860,206,797,269,792,274,100,93,94,81,93,104,106,95,101,101,98,34.29186046511628,201907
五反田店,1177,957,220,860,317,872,305,105,109,100,109,117,104,109,102,95,106,121,33.98223615464995,201907
代々木店,1403,1131,272,1048,355,1041,362,111,138,141,122,134,133,131,113,143,108,129,34.44650751547303,201907
伊勢原店,1490,1234,256,1103,387,1105,385,137,134,140,145,141,124,140,134,129,139,127,34.87682333873582,201907
伊勢崎店,1642,1336,306,1214,428,1219,423,157,133,143,154,151,139,160,173,153,133,146,34.925898203592816,201907
佐倉店,915,765,150,687,228,678,237,81,71,89,97,86,75,68,88,82,89,89,34.56209150326797,201907
佐野店,1543,1254,289,1148,395,1145,398,126,133,151,136,146,139,146,141,134,137,154,34.95773524720893,201907
保土ケ谷店,1307,1038,269,963,344,968,339,119,106,124,112,122,126,111,128,119,116,124,34.20712909441232,201907
入間店,1183,975,208,863,320,879,304,103,100,87,123,105,127,111,97,110,116,104,34.19076923076923,201907
八千代店,1272,1036,236,959,313,944,328,120,118,132,118,124,105,105,107,114,125,104,34.351351351351354,201907
八潮店,1241,1024,217,942,299,922,319,98,108,107,107,123,109,117,111,115,128,118,34.171875,201907
八王子店,1578,1276,302,1176,402,1172,406,152,142,140,146,154,131,146,140,153,130,144,35.122257053291534,201907
六本木店,1034,874,160,749,285,766,268,81,97,104,94,111,84,99,104,91,92,77,33.775743707093824,201907
前橋店,841,688,153,619,222,623,218,81,72,64,76,64,86,89,80,83,72,74,34.719476744186046,201907
北千住店,1029,815,214,756,273,761,268,92,93,95,117,76,87,96,85,95,108,85,34.732515337423315,201907
千葉中央店,1299,1061,238,941,358,961,338,118,125,138,115,123,105,109,106,99,131,130,34.12723845428841,201907
千葉緑店,1193,978,215,895,298,884,309,99,95,113,109,126,112,82,105,117,115,120,34.4918200408998,201907
南砂店,1306,1074,232,962,344,966,340,110,111,137,139,121,127,109,115,111,112,114,34.31843575418994,201907
南足柄店,1037,845,192,761,276,767,270,112,113,95,82,83,99,84,87,91,82,109,34.533727810650895,201907
厚木店,1496,1238,258,1130,366,1113,383,144,121,130,151,147,110,131,135,128,170,129,34.64943457189015,201907
取手店,1182,960,222,897,285,877,305,112,106,101,121,104,110,88,111,118,111,100,33.896875,201907
向島店,1064,880,184,811,253,791,273,76,101,103,110,97,110,91,102,83,94,97,33.89204545454545,201907
君津店,1122,930,192,810,312,831,291,98,107,107,101,100,93,119,90,87,118,102,34.405376344086015,201907
和光店,1331,1100,231,997,334,989,342,124,131,113,111,116,121,118,109,129,126,133,34.949090909090906,201907
品川店,1489,1208,281,1103,386,1105,384,143,129,135,141,131,122,136,137,135,147,133,34.07864238410596,201907
四街道店,853,701,152,642,211,632,221,70,93,70,71,66,74,83,76,82,80,88,34.175463623395146,201907
国分寺店,1009,816,193,729,280,751,258,85,89,97,91,94,87,93,115,80,94,84,35.598039215686285,201907
国立店,1400,1119,281,1012,388,1037,363,118,138,143,115,117,135,115,118,120,165,116,34.700625558534405,201907
坂戸店,1182,964,218,873,309,876,306,126,97,94,132,109,108,103,121,94,106,92,34.566390041493776,201907
墨田店,1008,834,174,745,263,745,263,89,88,101,83,89,88,87,98,102,90,93,34.79736211031175,201907
多摩店,1092,904,188,800,292,811,281,106,87,83,91,101,98,101,112,112,124,77,35.11725663716814,201907
大久保店,1068,863,205,803,265,791,277,99,99,105,97,95,108,117,82,89,84,93,34.39745075318656,201907
大井店,1215,1002,213,892,323,898,317,107,115,109,105,95,113,102,109,125,107,128,35.023952095808376,201907
大和店,1369,1121,248,1001,368,1017,352,113,141,127,111,116,116,124,133,131,121,136,34.71543264942016,201907
大塚店,1132,935,197,833,299,839,293,104,98,94,113,107,114,89,96,118,103,96,34.21818181818182,201907
大宮店,1353,1126,227,1030,323,1001,352,103,122,123,110,128,140,124,121,138,130,114,34.230905861456485,201907
大森店,1428,1160,268,1048,380,1059,369,133,110,143,154,134,133,121,109,132,124,135,33.78793103448276,201907
大泉店,1214,1013,201,905,309,901,313,111,111,105,111,88,121,133,124,88,112,110,34.22408687068115,201907
大田店,943,767,176,714,229,701,242,86,92,84,105,98,84,80,63,68,90,93,34.42633637548892,201907
太田店,1367,1123,244,995,372,1015,352,140,130,125,133,126,131,122,95,126,131,108,34.52359750667854,201907
宇都宮店,1098,878,220,818,280,817,281,104,110,109,95,95,99,102,96,99,98,91,34.66628701594533,201907
守谷店,1185,972,213,904,281,880,305,112,106,107,109,92,113,108,122,101,104,111,34.29423868312757,201907
宮前店,731,598,133,539,192,540,191,65,55,71,73,63,62,63,72,80,66,61,35.15886287625418,201907
富岡店,1092,872,220,817,275,813,279,97,112,89,95,94,108,99,126,98,103,71,34.303899082568805,201907
富津店,1034,861,173,751,283,767,267,103,85,103,77,81,85,109,85,118,93,95,34.09407665505226,201907
富里店,1489,1223,266,1085,404,1105,384,135,149,125,132,127,126,142,125,143,154,131,34.772690106296004,201907
小山店,1031,850,181,748,283,763,268,87,76,95,105,81,97,101,109,87,95,98,34.47176470588236,201907
小平店,1004,814,190,762,242,747,257,101,108,93,105,95,83,90,84,80,102,63,34.97911547911548,201907
小田原店,909,741,168,678,231,673,236,76,84,76,96,67,104,73,97,95,83,58,34.62753036437247,201907
小金井店,1091,885,206,792,299,807,284,91,94,95,113,97,93,96,108,88,113,103,34.856497175141236,201907
川口店,1117,916,201,803,314,827,290,104,86,111,95,92,97,100,106,117,107,102,34.698689956331876,201907
川崎多摩店,1116,907,209,842,274,830,286,92,100,107,102,80,112,113,94,105,97,114,34.28335170893054,201907
川崎店,1218,1009,209,907,311,903,315,114,116,108,109,97,98,108,128,115,110,115,46.59464816650149,201907
川越店,1149,939,210,864,285,856,293,119,94,97,100,113,120,94,108,91,102,111,47.64004259850906,201907
巣鴨店,1518,1245,273,1115,403,1130,388,116,140,131,139,146,136,154,131,154,123,148,34.263453815261045,201907
市原店,1182,964,218,865,317,876,306,107,107,98,130,99,103,108,105,97,120,108,34.336099585062236,201907
市川店,1180,983,197,885,295,875,305,115,103,107,105,119,98,122,102,106,100,103,47.6205493387589,201907
平塚店,1181,986,195,868,313,881,300,111,133,112,110,100,105,113,104,106,105,82,34.4290060851927,201907
幸店,1424,1170,254,1052,372,1055,369,135,154,140,113,141,134,134,104,99,138,132,33.94102564102564,201907
府中店,1244,1031,213,917,327,923,321,105,93,103,104,122,129,116,120,127,116,109,34.81959262851601,201907
座間店,1375,1101,274,1039,336,1022,353,117,106,138,118,119,146,112,119,118,141,141,34.87102633969119,201907
志木店,914,764,150,677,237,679,235,82,78,80,79,98,99,78,83,87,73,77,35.488219895287955,201907
恵比寿店,1028,830,198,781,247,768,260,99,99,85,101,108,86,84,93,104,75,94,19.8421686746988,201907
愛甲店,1059,862,197,789,270,786,273,109,91,108,100,100,107,93,96,92,84,79,34.78074245939675,201907
成城店,1367,1114,253,982,385,1019,348,154,123,128,119,145,109,118,113,124,131,103,34.97396768402155,201907
成田店,879,713,166,650,229,653,226,60,68,84,85,62,70,78,72,101,111,88,35.11500701262272,201907
我孫子店,1120,887,233,816,304,828,292,95,102,100,100,95,95,104,109,105,99,116,20.029312288613305,201907
戸塚店,1550,1256,294,1165,385,1151,399,143,147,133,148,135,127,144,143,158,132,140,34.816878980891715,201907
戸田店,1542,1295,247,1145,397,1140,402,134,142,141,139,151,149,152,121,155,137,121,34.766023166023174,201907
所沢店,1179,979,200,893,286,874,305,107,105,111,98,120,98,100,118,127,100,95,35.12461695607763,201907
新宿店,1092,889,203,854,238,810,282,79,98,89,103,99,111,100,105,104,101,103,34.72553430821147,201907
新座店,1035,861,174,771,264,767,268,104,96,91,106,81,91,87,81,96,94,108,34.08594657375145,201907
日本橋店,1459,1164,295,1096,363,1082,377,115,140,121,126,121,132,162,129,128,131,154,34.822164948453604,201907
日立店,1308,1066,242,974,334,969,339,108,117,122,124,122,124,114,107,108,122,140,35.26078799249531,201907
日野店,1157,966,191,869,288,858,299,113,109,117,101,100,108,103,108,113,87,98,34.63250517598345,201907
旭店,1241,1021,220,922,319,921,320,114,111,108,103,129,106,110,132,119,100,109,34.719882468168464,201907
春日部店,1181,962,219,867,314,873,308,112,110,88,106,100,99,116,104,117,124,105,34.40852390852391,201907
昭島店,1217,994,223,895,322,903,314,108,124,96,119,108,88,111,116,117,112,118,33.985915492957744,201907
木更津店,1121,905,216,811,310,832,289,103,101,95,103,102,107,94,90,115,105,106,34.479558011049726,201907
本庄店,1174,951,223,858,316,869,305,117,99,95,99,113,102,100,111,97,117,124,34.92849631966351,201907
本郷店,756,621,135,562,194,558,198,63,69,80,69,65,58,80,71,62,69,70,46.36876006441224,201907
杉並店,1248,1007,241,947,301,926,322,125,95,113,114,110,102,115,116,146,119,93,34.28798411122145,201907
東中野店,1426,1191,235,1045,381,1059,367,134,134,115,132,121,116,142,141,127,123,141,34.9647355163728,201907
東久留米店,877,706,171,655,222,651,226,82,89,81,78,60,71,83,77,92,91,73,34.82436260623229,201907
東大和店,1098,916,182,815,283,816,282,108,89,99,97,103,95,101,104,95,98,109,33.854803493449786,201907
東尾久店,1211,963,248,891,320,895,316,127,100,104,107,111,104,111,111,109,111,116,34.741433021806856,201907
東村山店,1064,860,204,800,264,789,275,95,98,94,92,99,81,104,112,90,104,95,34.384883720930226,201907
東松山店,1339,1104,235,996,343,995,344,146,128,123,122,116,111,123,112,119,122,117,34.40398550724637,201907
松戸店,1252,1008,244,951,301,925,327,100,108,115,102,123,114,130,114,112,105,129,34.12996031746032,201907
板橋店,1097,872,225,817,280,814,283,103,105,115,108,99,85,102,99,100,93,88,48.198394495412856,201907
柏店,1516,1233,283,1160,356,1121,395,155,127,127,137,153,152,127,134,133,150,121,34.75020275750203,201907
栃木店,1092,896,196,811,281,813,279,116,96,101,93,110,110,79,107,102,100,78,34.35044642857143,201907
栄店,1575,1294,281,1173,402,1175,400,121,130,132,143,146,154,153,161,140,160,135,20.57727975270479,201907
桐生店,1253,1038,215,907,346,931,322,122,125,113,117,102,116,121,102,122,112,101,34.0626204238921,201907
横浜南店,1414,1154,260,1081,333,1055,359,129,125,125,130,122,131,143,123,138,132,116,33.59012131715771,201907
横浜緑店,1312,1084,228,967,345,972,340,118,123,128,139,121,136,106,115,106,117,103,35.063653136531364,201907
横須賀店,1094,884,210,796,298,811,283,98,99,91,90,105,92,112,113,118,92,84,34.113122171945705,201907
武蔵村山店,1309,1091,218,953,356,972,337,105,111,118,120,128,120,118,109,120,138,122,34.198900091659034,201907
武蔵野店,1098,914,184,829,269,815,283,97,106,99,88,102,102,92,108,101,103,100,34.63676148796499,201907
水戸店,1395,1125,270,1029,366,1036,359,127,123,119,115,115,126,120,129,118,148,155,34.224000000000004,201907
江戸川店,1180,936,244,837,343,880,300,112,106,96,112,103,97,112,93,99,133,117,33.88034188034188,201907
江東店,1243,1054,189,908,335,921,322,94,113,112,109,133,105,142,107,106,120,102,34.51707779886148,201907
池尻店,1211,992,219,895,316,898,313,128,105,93,110,106,117,95,123,113,101,120,35.227822580645146,201907
池袋店,1467,1198,269,1063,404,1088,379,139,146,131,139,127,129,132,125,137,136,126,34.71118530884807,201907
泉店,1478,1197,281,1064,414,1094,384,147,135,123,108,134,142,135,145,124,139,146,34.21136173767753,201907
流山店,1517,1263,254,1137,380,1123,394,146,137,135,120,148,139,141,137,135,148,131,34.94140934283452,201907
浅草店,1395,1151,244,1034,361,1036,359,135,125,119,104,131,138,124,146,122,135,116,34.17463075586446,201907
浦和店,1312,1077,235,968,344,974,338,117,126,125,109,118,117,112,113,135,118,122,33.981429897864444,201907
浦安店,1326,1080,246,974,352,984,342,95,117,130,107,107,123,132,123,136,116,140,34.35185185185185,201907
海老名店,1181,960,221,886,295,880,301,122,96,108,111,96,109,109,102,100,111,117,34.88958333333333,201907
清瀬店,1060,886,174,779,281,790,270,103,94,96,110,96,106,83,95,89,96,92,34.39729119638827,201907
渋谷店,1156,926,230,843,313,857,299,96,103,115,101,104,104,101,96,137,99,100,34.3963282937365,201907
港北店,1032,836,196,747,285,766,266,96,91,87,106,97,91,107,91,96,96,74,20.608851674641148,201907
港南店,1245,1007,238,907,338,925,320,135,117,105,110,99,102,120,127,98,107,125,33.85004965243297,201907
瀬谷店,1454,1194,260,1095,359,1083,371,123,125,144,134,147,137,141,126,135,114,128,34.43383584589615,201907
熊谷店,1118,908,210,845,273,830,288,104,80,91,124,108,121,103,100,93,92,102,34.48458149779736,201907
狛江店,1252,1006,246,921,331,928,324,118,97,119,112,107,98,104,120,116,130,131,35.008946322067594,201907
狭山店,1435,1161,274,1081,354,1064,371,140,113,129,123,126,134,147,119,118,132,154,34.9526270456503,201907
王子店,1157,947,210,868,289,856,301,106,98,114,114,105,112,93,102,105,108,100,20.53854276663147,201907
町田店,1347,1112,235,986,361,1000,347,129,117,142,107,122,95,119,124,121,118,153,34.71762589928058,201907
白井店,1093,894,199,778,315,811,282,96,112,99,96,113,100,91,106,101,92,87,47.029082774049215,201907
目黒店,1210,1014,196,883,327,900,310,118,96,97,94,133,108,111,105,117,101,130,34.785996055226825,201907
相模原店,1490,1223,267,1141,349,1109,381,114,141,126,138,124,129,139,125,139,160,155,34.56009811937857,201907
石神井店,976,813,163,724,252,724,252,78,90,84,101,102,93,92,79,95,85,77,49.05781057810578,201907
磯子店,937,764,173,686,251,696,241,74,75,106,77,80,100,87,100,67,84,87,34.98298429319372,201907
神奈川店,1393,1141,252,1025,368,1035,358,127,119,107,118,133,140,117,121,130,130,151,34.12445223488168,201907
神田店,1452,1221,231,1079,373,1078,374,123,147,129,125,127,131,103,151,139,134,143,34.745290745290745,201907
福生店,1369,1121,248,1013,356,1020,349,132,120,114,135,132,132,121,115,124,120,124,34.73327386262266,201907
秦野店,1247,1012,235,917,330,925,322,105,125,126,110,114,125,110,102,106,113,111,34.84090909090909,201907
稲城店,974,771,203,722,252,721,253,81,84,96,89,91,95,100,76,84,80,98,46.381322957198435,201907
立川店,1313,1081,232,965,348,973,340,117,121,117,121,110,134,134,103,118,120,118,33.93524514338577,201907
綾瀬店,2712,2201,511,2008,704,2010,702,263,246,271,240,255,250,245,237,219,254,232,34.550658791458424,201907
練馬店,1426,1145,281,1054,372,1054,372,133,118,120,130,151,135,117,137,129,131,125,34.63668122270742,201907
羽村店,1399,1154,245,1017,382,1036,363,141,126,138,136,141,119,127,114,113,110,134,20.5632582322357,201907
羽生店,1338,1128,210,969,369,993,345,119,118,135,117,124,125,97,148,120,119,116,34.755319148936174,201907
習志野店,1423,1172,251,1035,388,1060,363,147,120,134,139,126,123,127,126,130,131,120,34.85153583617748,201907
自由が丘店,1311,1060,251,941,370,974,337,120,148,144,114,117,113,108,119,119,112,97,34.09622641509433,201907
船橋店,1496,1226,270,1105,391,1108,388,143,133,139,129,139,126,141,129,119,162,136,34.25448613376835,201907
若葉店,1185,965,220,888,297,880,305,112,92,97,124,115,97,113,124,114,109,88,34.61139896373057,201907
茂原店,1365,1144,221,986,379,1008,357,130,104,144,113,135,131,122,113,118,128,127,34.07604895104895,201907
茅ヶ崎店,913,738,175,662,251,679,234,97,84,78,58,94,98,76,83,75,63,107,35.31707317073171,201907
草加店,1002,793,209,755,247,746,256,89,85,90,95,94,106,89,92,90,84,88,33.85750315258512,201907
荒川店,913,725,188,686,227,678,235,78,78,78,82,90,79,92,86,80,75,95,33.89793103448276,201907
荻窪店,1245,1012,233,918,327,922,323,119,109,101,119,95,130,128,106,120,120,98,20.51086956521739,201907
葛飾店,1157,943,214,860,297,855,302,113,95,113,124,111,87,102,92,110,92,118,34.626723223753984,201907
蒲田店,1033,860,173,749,284,766,267,95,95,103,94,108,73,100,96,91,92,86,34.74418604651163,201907
藤沢店,1189,998,191,860,329,885,304,135,92,98,103,103,116,114,92,122,108,106,34.754509018036075,201907
行田店,998,804,194,751,247,738,260,98,93,93,84,87,95,92,92,94,79,91,33.983830845771145,201907
西多摩店,1576,1267,309,1178,398,1164,412,156,146,139,151,154,142,151,142,121,153,121,34.57142857142857,201907
西東京店,1002,838,164,730,272,744,258,98,95,74,99,78,106,90,106,79,91,86,33.8472553699284,201907
西葛西店,823,668,155,609,214,611,212,81,66,81,85,60,75,84,80,63,74,74,34.444610778443106,201907
調布店,1439,1156,283,1075,364,1070,369,124,147,122,145,115,125,149,123,134,131,124,35.174740484429066,201907
谷中店,1552,1279,273,1149,403,1153,399,137,159,147,149,142,148,138,135,142,115,140,34.13369820172009,201907
赤坂店,1031,836,195,764,267,760,271,98,100,92,95,88,84,93,101,87,103,90,35.11483253588517,201907
赤羽店,1182,969,213,864,318,877,305,92,87,105,106,122,105,115,103,137,110,100,48.973168214654294,201907
越谷店,911,727,184,692,219,678,233,102,90,87,71,82,79,87,84,85,73,71,47.49931224209078,201907
足利店,821,649,172,611,210,609,212,72,92,69,79,56,75,78,78,71,70,81,34.1386748844376,201907
足柄上店,1245,1017,228,939,306,919,326,101,119,125,121,117,95,130,108,99,114,116,35.03343166175024,201907
足立店,875,700,175,612,263,652,223,71,84,85,80,76,94,73,74,71,101,66,34.29142857142857,201907
逗子店,1091,889,202,797,294,808,283,103,88,101,86,87,105,99,93,94,116,119,34.6400449943757,201907
那珂店,1218,1007,211,894,324,905,313,105,110,96,107,120,106,124,115,109,118,108,20.312810327706057,201907
都筑店,1038,848,190,787,251,772,266,85,79,97,102,99,91,93,93,114,91,94,33.39740566037736,201907
金沢店,1281,1054,227,957,324,951,330,126,114,118,126,136,110,123,116,101,110,101,20.55123339658445,201907
銀座店,1004,842,162,745,259,745,259,101,88,80,88,84,96,92,105,94,78,98,34.76128266033254,201907
鎌倉店,998,807,191,728,270,739,259,84,86,96,94,86,82,101,92,93,103,81,34.633209417596035,201907
青山店,1365,1123,242,979,386,1015,350,116,118,126,114,130,118,126,120,143,120,134,33.94300979519145,201907
青梅店,1264,1034,230,944,320,936,328,105,128,109,113,109,120,96,122,127,111,124,34.178916827852994,201907
青葉店,1148,943,205,801,347,858,290,117,103,103,103,103,108,107,104,95,104,101,33.94803817603393,201907
館林店,1178,946,232,851,327,873,305,123,112,130,104,105,121,88,104,111,96,84,35.0708245243129,201907
駒沢店,1040,841,199,778,262,770,270,100,89,113,101,92,80,117,102,92,74,80,35.41141498216409,201907
駒込店,1497,1240,257,1090,407,1112,385,150,127,131,151,137,125,132,140,141,122,141,34.435483870967744,201907
高円寺店,1425,1148,277,1058,367,1055,370,143,119,124,144,126,136,141,130,119,124,119,34.1794425087108,201907
高島平店,1242,1021,221,946,296,926,316,119,107,102,127,114,139,106,109,102,98,119,34.49951028403526,201907
高崎店,1158,927,231,841,317,857,301,107,107,90,108,122,101,125,96,94,101,107,34.9881337648328,201907
高座店,1154,946,208,862,292,855,299,105,104,106,95,103,98,96,111,103,112,121,35.19027484143763,201907
高津店,1152,960,192,846,306,855,297,104,104,115,106,121,90,102,104,100,101,105,34.44583333333333,201907
高田馬場店,1095,923,172,807,288,812,283,89,100,98,87,112,100,99,90,105,106,109,35.062838569880824,201907
鴻巣店,1154,939,215,857,297,855,299,103,91,116,92,110,109,97,102,107,123,104,35.08732694355697,201907
鶴見店,1512,1247,265,1102,410,1121,391,123,140,151,147,122,131,122,134,138,161,143,35.174017642341624,201907
麻生店,1390,1143,247,1021,369,1029,361,122,123,134,126,128,139,105,154,122,114,123,34.90726159230096,201907
あきる野店,1178,967,211,876,302,835,343,100,97,103,110,115,128,100,121,96,106,102,34.607032057911056,201908
さいたま南店,1550,1273,277,1148,402,1101,449,135,152,155,140,133,147,132,131,135,134,156,34.461115475255305,201908
さいたま緑店,1068,880,188,789,279,759,309,101,98,90,99,97,108,87,78,98,101,111,34.42272727272727,201908
さいたま西店,1225,1012,213,917,308,866,359,105,120,114,113,111,97,104,117,108,112,124,34.241106719367586,201908
つくば店,1304,1056,248,1008,296,925,379,119,132,118,111,115,117,104,126,128,109,125,33.98579545454545,201908
三浦店,1184,961,223,873,311,841,343,102,102,99,96,115,109,100,104,100,130,127,34.170655567117585,201908
三鷹店,1551,1253,298,1120,431,1102,449,140,138,143,154,155,140,133,146,134,142,126,33.67677573822825,201908
上尾店,1367,1103,264,980,387,969,398,118,111,129,125,134,129,125,131,123,122,120,20.18313689936536,201908
上野店,1676,1343,333,1245,431,1192,484,146,132,157,165,154,158,143,177,150,137,157,34.004467609828744,201908
世田谷店,1585,1283,302,1153,432,1123,462,128,131,140,136,153,137,146,170,150,129,165,34.98674980514419,201908
中原店,1589,1247,342,1181,408,1123,466,165,138,122,148,139,141,147,145,137,149,158,34.196471531676025,201908
中店,1239,1003,236,932,307,884,355,94,129,108,130,116,123,102,96,114,116,111,33.979062811565306,201908
中野店,1196,973,223,887,309,847,349,132,111,110,98,101,107,109,102,114,113,99,34.22816032887975,201908
久喜店,1334,1116,218,987,347,948,386,121,118,115,100,144,120,129,114,136,119,118,34.446236559139784,201908
九段店,1370,1112,258,1026,344,971,399,122,121,109,125,144,137,124,137,112,109,130,35.37769784172661,201908
亀有店,1066,871,195,794,272,756,310,103,83,92,98,96,95,110,97,92,101,99,35.0459242250287,201908
五反田店,1171,962,209,884,287,834,337,102,101,104,112,103,116,106,118,88,99,122,34.903326403326396,201908
代々木店,1401,1136,265,1032,369,992,409,131,141,144,110,118,123,123,105,156,130,120,34.099471830985905,201908
伊勢原店,1492,1224,268,1117,375,1056,436,136,137,149,124,132,131,137,146,133,127,140,34.55718954248365,201908
伊勢崎店,1645,1342,303,1253,392,1167,478,160,135,134,159,156,134,164,157,138,155,153,34.64381520119225,201908
佐倉店,917,753,164,680,237,650,267,87,86,84,83,77,87,89,64,80,93,87,34.243027888446214,201908
佐野店,1549,1276,273,1137,412,1101,448,146,131,151,167,138,111,156,147,131,141,130,34.888714733542315,201908
保土ケ谷店,1309,1080,229,977,332,932,377,113,123,116,124,126,126,120,131,102,122,106,33.93333333333333,201908
入間店,1184,960,224,891,293,837,347,107,120,123,102,102,116,110,100,90,123,91,34.11145833333333,201908
八千代店,1277,1049,228,915,362,905,372,116,111,102,127,129,105,112,130,107,118,120,35.02192564346997,201908
八潮店,1231,1001,230,906,325,876,355,102,108,112,116,100,122,111,118,113,106,123,34.05494505494506,201908
八王子店,1580,1306,274,1153,427,1123,457,132,150,144,142,146,126,150,150,143,165,132,34.46477794793262,201908
六本木店,1033,835,198,755,278,734,299,94,96,96,98,85,91,99,86,102,87,99,34.289820359281435,201908
前橋店,853,696,157,632,221,607,246,78,103,73,77,74,74,83,82,61,75,73,34.43103448275862,201908
北千住店,1032,849,183,747,285,736,296,90,106,98,90,96,98,76,101,100,91,86,34.8150765606596,201908
千葉中央店,1296,1063,233,925,371,922,374,115,101,109,112,100,120,120,132,139,111,137,34.83349012229539,201908
千葉緑店,1185,969,216,865,320,841,344,94,92,103,104,111,110,104,127,111,113,116,34.326109391124874,201908
南砂店,1307,1047,260,946,361,925,382,108,134,115,118,130,132,111,118,115,115,111,34.63323782234957,201908
南足柄店,1031,851,180,768,263,730,301,85,87,88,79,96,109,104,79,101,100,103,34.64394829612221,201908
厚木店,1493,1201,292,1097,396,1059,434,128,145,122,141,123,124,121,148,148,143,150,34.15154038301416,201908
取手店,1185,956,229,868,317,841,344,109,102,116,95,114,114,101,109,122,90,113,33.65481171548117,201908
向島店,1066,873,193,771,295,757,309,92,98,116,93,99,98,103,80,98,109,80,34.404352806414664,201908
君津店,1123,877,246,824,299,793,330,95,101,96,107,89,120,90,102,107,121,95,35.322690992018245,201908
和光店,1341,1083,258,990,351,949,392,120,128,138,111,117,97,123,126,115,143,123,34.607571560480146,201908
品川店,1485,1207,278,1128,357,1055,430,138,137,126,128,149,122,128,121,136,154,146,34.95111847555924,201908
四街道店,856,684,172,633,223,606,250,88,86,79,76,86,59,58,90,84,73,77,34.56140350877193,201908
国分寺店,1008,812,196,731,277,717,291,98,85,94,87,93,91,115,76,92,92,85,34.04802955665025,201908
国立店,1404,1146,258,1027,377,993,411,153,131,138,132,111,125,124,105,131,134,120,34.297556719022694,201908
坂戸店,1182,981,201,873,309,835,347,110,103,101,109,118,114,107,102,108,103,107,34.34862385321101,201908
墨田店,999,789,210,754,245,707,292,92,70,96,98,111,114,86,82,80,99,71,34.017743979721175,201908
多摩店,1092,882,210,791,301,776,316,95,87,97,102,101,124,103,91,94,85,113,34.828798185941054,201908
大久保店,1059,853,206,801,258,751,308,85,88,110,95,95,90,102,99,86,88,121,34.86400937866354,201908
大井店,1216,974,242,912,304,864,352,118,112,110,114,129,100,105,81,113,123,111,34.496919917864474,201908
大和店,1371,1116,255,1019,352,973,398,124,115,112,132,153,128,122,108,117,131,129,35.212365591397855,201908
大塚店,1126,944,182,819,307,800,326,108,105,102,88,90,104,109,113,91,112,104,33.84957627118644,201908
大宮店,1370,1105,265,1022,348,972,398,133,137,127,124,131,122,111,121,116,130,118,34.34751131221719,201908
大森店,1427,1164,263,1054,373,1012,415,108,127,138,122,137,134,139,136,118,139,129,34.82903780068729,201908
大泉店,1218,979,239,876,342,863,355,106,117,93,108,107,119,114,106,117,128,103,34.2635342185904,201908
大田店,950,777,173,718,232,672,278,77,90,80,86,88,80,82,90,86,78,113,34.907335907335906,201908
太田店,1361,1090,271,1006,355,969,392,119,111,119,126,120,136,115,139,136,116,124,34.55045871559633,201908
宇都宮店,1100,892,208,780,320,784,316,99,76,94,94,84,115,86,117,117,106,112,35.47645739910314,201908
守谷店,1191,961,230,870,321,848,343,103,119,103,109,108,126,116,101,91,91,124,35.32778355879292,201908
宮前店,724,595,129,548,176,516,208,70,74,52,75,53,69,67,77,72,64,51,34.8218487394958,201908
富岡店,1087,874,213,802,285,769,318,102,84,107,114,96,108,81,84,99,98,114,34.36727688787185,201908
富津店,1040,848,192,773,267,742,298,95,94,90,90,90,94,105,98,90,97,97,34.60377358490566,201908
富里店,1492,1193,299,1092,400,1061,431,124,122,134,147,135,136,137,136,144,130,147,34.19446772841576,201908
小山店,1034,846,188,774,260,734,300,101,101,95,98,89,82,85,100,100,94,89,34.32151300236407,201908
小平店,999,832,167,742,257,710,289,92,89,90,103,89,85,88,94,89,96,84,34.62620192307692,201908
小田原店,913,757,156,676,237,649,264,77,77,98,91,81,87,91,74,69,88,80,33.90224570673712,201908
小金井店,1085,896,189,794,291,769,316,104,103,84,101,75,95,111,102,101,107,102,34.863839285714285,201908
川口店,1128,907,221,815,313,803,325,100,97,99,104,97,116,109,100,99,103,104,35.1587651598677,201908
川崎多摩店,1129,940,189,849,280,802,327,85,103,101,104,103,94,123,100,121,93,102,33.65212765957447,201908
川崎店,1217,990,227,912,305,864,353,101,106,129,117,97,103,111,113,114,98,128,49.373737373737384,201908
川越店,1151,931,220,848,303,815,336,96,111,113,116,107,115,97,91,95,108,102,48.167561761546715,201908
巣鴨店,1522,1224,298,1143,379,1079,443,149,125,146,154,133,147,128,115,133,159,133,34.34885620915033,201908
市原店,1193,980,213,876,317,844,349,96,107,115,103,103,123,111,96,116,97,126,33.76122448979592,201908
市川店,1180,954,226,871,309,838,342,106,96,107,111,105,118,95,111,118,108,105,48.70964360587003,201908
平塚店,1186,974,212,876,310,845,341,102,116,104,123,104,110,107,105,100,105,110,34.70328542094456,201908
幸店,1424,1187,237,1050,374,1009,415,140,126,139,133,115,135,137,117,137,117,128,34.330244313395106,201908
府中店,1239,1028,211,923,316,876,363,106,114,133,122,108,120,111,105,120,92,108,34.628404669260696,201908
座間店,1374,1141,233,1026,348,974,400,129,134,129,126,119,129,132,113,106,131,126,34.292725679228745,201908
志木店,904,753,151,673,231,642,262,88,88,87,75,68,80,95,76,82,87,78,34.69322709163347,201908
恵比寿店,1034,849,185,780,254,731,303,91,91,94,102,86,85,92,82,101,105,105,20.551236749116608,201908
愛甲店,1070,851,219,796,274,759,311,105,89,104,106,104,88,131,82,89,88,84,34.688601645123384,201908
成城店,1369,1099,270,1001,368,970,399,116,119,138,145,132,113,107,126,123,123,127,34.16833484986351,201908
成田店,886,736,150,669,217,627,259,87,80,84,80,69,74,81,77,79,106,69,34.921195652173914,201908
我孫子店,1121,927,194,833,288,799,322,113,100,95,93,113,96,96,107,92,108,108,20.48435814455232,201908
戸塚店,1545,1245,300,1175,370,1099,446,165,137,147,155,127,135,128,133,148,129,141,34.264257028112446,201908
戸田店,1554,1271,283,1152,402,1103,451,146,129,145,137,125,156,141,133,133,156,153,33.70653029110936,201908
所沢店,1187,963,224,890,297,839,348,108,104,101,114,131,89,104,108,104,116,108,33.742471443406025,201908
新宿店,1078,892,186,810,268,762,316,83,100,86,97,89,122,116,98,91,95,101,34.59417040358744,201908
新座店,1031,846,185,773,258,729,302,97,82,85,106,98,102,90,84,83,98,106,34.14420803782506,201908
日本橋店,1465,1167,298,1074,391,1040,425,144,133,135,142,127,132,130,131,125,113,153,34.62810625535561,201908
日立店,1302,1061,241,991,311,930,372,109,121,130,115,109,114,127,114,118,123,122,34.58529688972667,201908
日野店,1142,940,202,872,270,813,329,109,94,89,113,105,101,108,108,95,113,107,34.77127659574468,201908
旭店,1243,1020,223,917,326,882,361,119,117,95,119,109,96,104,117,119,115,133,34.561764705882354,201908
春日部店,1182,960,222,883,299,838,344,105,110,112,122,100,103,109,87,119,108,107,35.09270833333333,201908
昭島店,1215,975,240,879,336,866,349,112,113,122,104,104,123,120,96,109,100,112,33.846153846153854,201908
木更津店,1120,920,200,824,296,794,326,90,103,99,106,91,110,104,96,107,111,103,34.31847826086957,201908
本庄店,1185,981,204,895,290,843,342,105,101,116,121,119,100,108,112,111,100,92,35.333333333333336,201908
本郷店,758,616,142,565,193,539,219,91,64,58,63,66,75,61,77,65,64,74,48.310064935064936,201908
杉並店,1243,1014,229,925,318,885,358,117,96,114,102,104,127,119,119,121,99,125,33.93195266272189,201908
東中野店,1425,1165,260,1065,360,1013,412,112,137,145,126,129,133,133,136,121,129,124,34.209442060085834,201908
東久留米店,889,711,178,635,254,633,256,70,80,74,86,86,88,80,78,81,81,85,33.78481012658228,201908
東大和店,1091,892,199,794,297,776,315,119,88,88,102,81,108,95,115,101,100,94,34.13677130044843,201908
東尾久店,1217,998,219,917,300,865,352,124,103,126,99,117,114,110,112,109,104,99,34.078156312625254,201908
東村山店,1064,882,182,784,280,754,310,100,94,87,99,103,95,104,78,99,91,114,34.26757369614513,201908
東松山店,1335,1102,233,998,337,945,390,137,123,130,116,110,125,123,102,119,107,143,33.95281306715064,201908
松戸店,1247,1038,209,928,319,882,365,125,122,106,108,108,102,121,109,102,122,122,34.38631984585741,201908
板橋店,1098,898,200,824,274,778,320,89,92,127,95,109,97,88,90,104,100,107,48.41982182628063,201908
柏店,1506,1239,267,1121,385,1071,435,133,156,140,121,120,153,111,144,155,148,125,34.5270379338176,201908
栃木店,1089,879,210,805,284,773,316,98,105,98,91,106,94,106,77,111,108,95,35.032992036405005,201908
栄店,1592,1297,295,1193,399,1131,461,151,130,167,147,154,136,151,144,142,118,152,20.518118735543567,201908
桐生店,1244,1009,235,917,327,884,360,122,102,101,115,98,107,130,110,123,108,128,34.28444003964321,201908
横浜南店,1424,1159,265,1062,362,1016,408,120,131,120,118,142,147,122,125,153,109,137,34.679033649698006,201908
横浜緑店,1307,1068,239,953,354,926,381,113,114,121,122,119,106,119,123,107,145,118,34.517790262172284,201908
横須賀店,1091,890,201,796,295,779,312,112,91,95,102,112,89,88,110,85,103,104,34.03370786516854,201908
武蔵村山店,1296,1056,240,986,310,926,370,118,112,111,122,131,137,111,124,120,119,91,34.08901515151515,201908
武蔵野店,1097,924,173,805,292,775,322,86,101,93,108,92,94,114,95,112,103,99,34.71645021645022,201908
水戸店,1400,1153,247,1036,364,995,405,123,136,115,132,106,141,124,129,133,121,140,34.49002601908066,201908
江戸川店,1185,973,212,878,307,839,346,120,114,99,116,107,85,101,111,121,105,106,34.09044193216855,201908
江東店,1241,1031,210,933,308,881,360,120,105,100,128,106,97,118,127,120,101,119,34.18816682832202,201908
池尻店,1220,999,221,886,334,869,351,114,109,110,123,87,121,125,109,109,108,105,33.710710710710714,201908
池袋店,1461,1164,297,1092,369,1035,426,121,140,123,124,124,162,130,124,124,140,149,34.141752577319586,201908
泉店,1492,1228,264,1148,344,1059,433,139,130,120,139,128,135,135,144,148,147,127,34.395765472312696,201908
流山店,1517,1230,287,1122,395,1079,438,143,133,152,136,139,136,130,150,118,126,154,34.63252032520325,201908
浅草店,1403,1158,245,1047,356,996,407,141,109,102,127,150,113,120,146,140,127,128,34.618307426597575,201908
浦和店,1298,1045,253,950,348,917,381,127,113,120,135,109,101,112,112,136,126,107,34.13684210526316,201908
浦安店,1338,1102,236,996,342,952,386,114,106,118,118,108,120,123,129,119,146,137,34.76588021778584,201908
海老名店,1189,988,201,884,305,846,343,87,119,100,103,92,107,105,114,125,112,125,34.97874493927125,201908
清瀬店,1062,865,197,791,271,754,308,96,88,117,98,109,89,107,96,80,91,91,33.94450867052023,201908
渋谷店,1153,954,199,853,300,818,335,100,100,125,98,99,105,124,116,94,103,89,34.32075471698113,201908
港北店,1032,841,191,744,288,733,299,79,94,107,85,85,100,96,95,99,100,92,19.55410225921522,201908
港南店,1251,1068,183,892,359,891,360,104,104,103,125,112,126,120,109,102,127,119,34.78838951310861,201908
瀬谷店,1452,1207,245,1061,391,1030,422,137,121,127,117,146,129,134,142,131,133,135,33.56089478044739,201908
熊谷店,1128,936,192,844,284,799,329,97,96,97,91,111,99,108,124,88,101,116,34.970085470085465,201908
狛江店,1239,1029,210,917,322,880,359,110,105,121,112,106,103,120,128,105,129,100,34.285714285714285,201908
狭山店,1429,1159,270,1054,375,1015,414,132,131,129,113,137,141,127,130,118,121,150,34.62467644521139,201908
王子店,1158,959,199,865,293,823,335,96,101,98,109,116,125,106,108,97,97,105,20.346193952033367,201908
町田店,1339,1091,248,996,343,952,387,137,108,148,120,134,111,108,119,111,119,124,34.082493125572874,201908
白井店,1098,902,196,812,286,777,321,110,95,103,114,80,114,98,91,109,79,105,47.21729490022173,201908
目黒店,1215,1000,215,902,313,863,352,115,95,96,115,106,105,125,109,112,128,109,35.194,201908
相模原店,1486,1204,282,1131,355,1054,432,154,139,132,120,133,152,129,118,142,125,142,35.01744186046512,201908
石神井店,976,785,191,737,239,691,285,88,94,89,71,83,87,105,91,84,102,82,48.10445859872611,201908
磯子店,939,770,169,714,225,663,276,85,85,84,72,96,93,93,83,79,87,82,34.41168831168831,201908
神奈川店,1405,1152,253,1038,367,998,407,119,131,143,140,113,138,117,122,118,127,137,34.53211805555556,201908
神田店,1456,1193,263,1090,366,1032,424,135,151,132,123,127,140,139,134,133,111,131,33.85414920368818,201908
福生店,1358,1121,237,1015,343,964,394,112,125,127,130,126,126,120,116,122,138,116,35.02051739518287,201908
秦野店,1257,1028,229,960,297,895,362,115,111,129,113,102,126,121,97,119,120,104,33.87256809338521,201908
稲城店,980,812,168,704,276,698,282,86,90,95,98,82,89,99,72,84,92,93,46.70935960591133,201908
立川店,1313,1052,261,968,345,932,381,120,122,138,113,120,104,117,101,142,121,115,33.739543726235745,201908
綾瀬店,2710,2222,488,2007,703,1927,783,261,271,238,246,253,226,243,235,250,252,235,34.36408640864086,201908
練馬店,1424,1147,277,1010,414,1014,410,137,132,102,122,136,134,140,116,117,131,157,34.306887532693985,201908
羽村店,1386,1153,233,1016,370,983,403,105,127,133,121,134,126,133,142,124,120,121,20.37814397224632,201908
羽生店,1335,1101,234,980,355,945,390,121,121,104,119,127,118,131,122,127,118,127,34.665758401453225,201908
習志野店,1435,1146,289,1077,358,1017,418,114,152,126,91,138,135,134,130,128,122,165,34.33071553228621,201908
自由が丘店,1308,1065,243,977,331,927,381,100,138,117,97,125,131,126,128,121,123,102,35.188732394366205,201908
船橋店,1489,1213,276,1109,380,1057,432,136,132,133,139,160,130,124,128,127,130,150,34.09068425391591,201908
若葉店,1186,960,226,871,315,847,339,115,101,122,123,106,106,98,103,98,114,100,34.48229166666667,201908
茂原店,1371,1125,246,1004,367,973,398,117,119,113,108,145,128,108,134,131,139,129,35.056888888888885,201908
茅ヶ崎店,916,761,155,694,222,652,264,89,88,74,81,94,85,83,75,71,87,89,34.434954007884365,201908
草加店,1008,830,178,758,250,715,293,103,90,97,90,91,88,88,79,104,85,93,34.10361445783133,201908
荒川店,910,732,178,676,234,647,263,83,89,85,83,89,92,74,78,83,86,68,34.614754098360656,201908
荻窪店,1248,1017,231,918,330,883,365,114,114,112,108,118,84,106,139,111,128,114,20.27040314650934,201908
葛飾店,1162,948,214,849,313,823,339,108,104,116,94,123,113,84,102,103,115,100,34.641350210970465,201908
蒲田店,1038,839,199,757,281,736,302,95,84,103,92,100,93,90,104,82,100,95,34.331346841477945,201908
藤沢店,1182,984,198,856,326,840,342,106,110,111,91,102,108,94,111,114,131,104,35.227642276422756,201908
行田店,1004,825,179,741,263,716,288,84,92,92,78,89,78,86,109,107,101,88,34.93090909090909,201908
西多摩店,1582,1279,303,1181,401,1121,461,130,142,142,132,164,155,163,131,144,152,127,33.871774824081314,201908
西東京店,1007,836,171,720,287,712,295,86,85,87,93,90,99,93,75,107,88,104,34.936602870813395,201908
西葛西店,813,653,160,634,179,577,236,80,70,67,71,78,86,80,61,76,76,68,35.494640122511484,201908
調布店,1423,1164,259,1067,356,1010,413,123,108,124,123,151,128,129,152,138,130,117,34.753436426116835,201908
谷中店,1550,1273,277,1162,388,1100,450,142,140,140,139,137,142,132,147,138,154,139,34.371563236449326,201908
赤坂店,1030,827,203,757,273,730,300,81,85,95,82,101,83,90,110,121,94,88,34.18863361547763,201908
赤羽店,1189,965,224,866,323,843,346,124,107,112,105,102,104,115,101,109,93,117,48.03212435233161,201908
越谷店,917,752,165,696,221,650,267,88,83,79,75,104,84,77,84,83,81,79,47.446808510638284,201908
足利店,821,683,138,602,219,584,237,60,63,100,72,67,71,93,78,68,75,74,35.295754026354324,201908
足柄上店,1243,1021,222,942,301,880,363,107,122,110,112,96,122,111,106,123,113,121,34.084231145935355,201908
足立店,881,719,162,657,224,623,258,78,76,78,59,86,91,74,85,73,85,96,35.158553546592486,201908
逗子店,1093,881,212,824,269,775,318,104,103,102,96,99,102,97,101,97,92,100,34.72304199772985,201908
那珂店,1218,972,246,917,301,863,355,110,109,125,109,115,105,114,91,116,100,124,20.166666666666668,201908
都筑店,1034,846,188,766,268,735,299,100,96,80,90,104,87,84,106,96,103,88,34.677304964539005,201908
金沢店,1265,1034,231,929,336,895,370,105,105,102,124,98,127,120,117,123,118,126,20.11121856866538,201908
銀座店,999,812,187,733,266,709,290,101,91,109,107,101,96,67,85,87,85,70,33.92118226600985,201908
鎌倉店,998,801,197,731,267,709,289,86,121,84,94,75,88,92,83,105,75,95,34.458177278402,201908
青山店,1371,1120,251,1007,364,974,397,116,129,115,119,134,116,116,133,127,132,134,34.95892857142857,201908
青梅店,1286,1058,228,955,331,914,372,129,114,106,125,108,138,112,116,111,107,120,34.04253308128544,201908
青葉店,1153,937,216,866,287,821,332,98,109,116,112,100,102,99,95,95,112,115,33.40875133404481,201908
館林店,1177,952,225,879,298,836,341,107,105,103,110,122,101,125,96,109,104,95,35.17436974789916,201908
駒沢店,1023,837,186,779,244,725,298,90,83,94,106,98,77,100,91,95,88,101,33.71445639187575,201908
駒込店,1487,1213,274,1094,393,1057,430,147,124,144,136,113,127,145,131,138,137,145,34.702390766694144,201908
高円寺店,1427,1167,260,1086,341,1013,414,142,142,139,147,141,115,103,141,117,121,119,34.4293059125964,201908
高島平店,1250,1021,229,921,329,886,364,106,129,106,114,131,112,98,130,103,113,108,34.6258570029383,201908
高崎店,1154,935,219,869,285,814,340,115,102,104,122,95,93,100,106,115,95,107,33.92192513368984,201908
高座店,1149,952,197,858,291,814,335,105,93,113,104,117,97,84,107,115,99,115,35.51680672268908,201908
高津店,1160,959,201,863,297,820,340,97,88,104,104,111,117,111,104,102,107,115,33.711157455683,201908
高田馬場店,1099,904,195,816,283,779,320,99,102,101,106,104,91,104,106,98,81,107,34.875,201908
鴻巣店,1159,942,217,845,314,822,337,99,106,111,109,97,111,88,111,111,105,111,34.2515923566879,201908
鶴見店,1516,1263,253,1107,409,1079,437,128,151,145,126,125,138,159,145,140,127,132,34.93665874901029,201908
麻生店,1398,1140,258,1006,392,992,406,119,130,121,119,124,133,122,132,131,132,135,34.049122807017554,201908
あきる野店,1149,933,216,855,294,802,347,111,99,84,117,110,105,103,109,109,96,106,34.17470525187567,201909
さいたま南店,1503,1260,243,1115,388,1050,453,138,153,126,145,129,142,128,134,136,127,145,33.91111111111111,201909
さいたま緑店,1029,815,214,745,284,722,307,83,92,90,91,89,89,111,88,81,108,107,33.9521472392638,201909
さいたま西店,1177,966,211,868,309,822,355,97,123,116,102,86,103,104,111,92,118,125,34.15320910973085,201909
つくば店,1255,1023,232,933,322,877,378,117,113,138,114,113,94,123,108,117,100,118,33.78592375366569,201909
三浦店,1144,936,208,858,286,802,342,92,97,113,115,111,100,120,101,94,111,90,33.57692307692308,201909
三鷹店,1503,1242,261,1135,368,1051,452,151,109,157,140,128,130,137,142,145,133,131,34.689210950080515,201909
上尾店,1325,1103,222,995,330,931,394,110,129,121,125,94,141,103,110,115,127,150,20.01541251133273,201909
上野店,1618,1314,304,1191,427,1132,486,154,150,149,143,161,145,142,135,143,160,136,34.387366818873666,201909
世田谷店,1530,1279,251,1130,400,1072,458,155,131,165,132,146,123,121,138,133,150,136,34.54808444096951,201909
中原店,1530,1236,294,1107,423,1073,457,152,146,141,122,152,132,125,136,137,139,148,34.406148867313924,201909
中店,1209,961,248,881,328,843,366,117,107,92,129,117,112,110,110,104,97,114,33.89386056191467,201909
中野店,1148,931,217,836,312,801,347,99,109,116,108,98,103,77,138,97,103,100,34.22878625134264,201909
久喜店,1290,1049,241,963,327,903,387,120,127,102,135,96,121,137,114,123,106,109,35.028598665395606,201909
九段店,1320,1065,255,1001,319,924,396,117,112,127,128,130,115,105,128,133,120,105,34.44225352112676,201909
亀有店,1030,834,196,738,292,721,309,95,74,84,86,94,71,110,109,98,109,100,34.715827338129486,201909
五反田店,1152,937,215,851,301,804,348,100,111,105,112,94,112,101,104,86,107,120,34.76200640341516,201909
代々木店,1345,1088,257,993,352,942,403,131,126,133,130,84,112,126,129,121,125,128,34.92279411764706,201909
伊勢原店,1445,1186,259,1088,357,1008,437,127,123,111,145,128,150,128,144,121,145,123,34.06576728499157,201909
伊勢崎店,1586,1298,288,1179,407,1109,477,146,146,151,155,148,140,144,156,145,133,122,34.030816640986124,201909
佐倉店,883,722,161,660,223,616,267,81,91,92,82,80,83,76,66,80,69,83,34.87257617728532,201909
佐野店,1497,1230,267,1131,366,1052,445,129,136,139,151,163,111,143,126,132,134,133,34.13658536585365,201909
保土ケ谷店,1262,1014,248,908,354,881,381,104,115,119,115,109,115,119,127,108,119,112,34.200197238658774,201909
入間店,1148,950,198,855,293,802,346,97,88,98,105,126,108,111,99,98,121,97,34.950526315789475,201909
八千代店,1235,989,246,934,301,863,372,114,120,107,122,108,95,119,112,119,112,107,34.339737108190086,201909
八潮店,1201,970,231,891,310,844,357,125,89,103,108,107,118,104,114,91,130,112,34.503092783505146,201909
八王子店,1529,1260,269,1119,410,1076,453,122,137,146,151,155,140,133,136,139,137,133,34.39126984126984,201909
六本木店,998,805,193,731,267,695,303,78,96,92,93,87,82,95,99,97,92,87,33.718012422360246,201909
前橋店,818,642,176,596,222,572,246,70,67,71,73,85,64,91,72,76,83,66,35.46417445482866,201909
北千住店,1002,811,191,726,276,706,296,76,87,92,76,93,96,99,97,88,98,100,35.25400739827373,201909
千葉中央店,1256,1020,236,931,325,879,377,125,117,124,140,107,101,94,121,105,114,108,34.56078431372549,201909
千葉緑店,1149,939,210,848,301,805,344,100,102,87,87,124,114,85,111,128,118,93,34.27689030883919,201909
南砂店,1266,1051,215,907,359,885,381,112,118,114,113,121,118,106,121,126,102,115,34.548049476688874,201909
南足柄店,1000,828,172,772,228,701,299,92,84,105,96,86,86,92,86,87,100,86,34.15217391304348,201909
厚木店,1438,1179,259,1051,387,1007,431,142,115,137,140,122,117,136,129,138,138,124,34.40542832909245,201909
取手店,1143,929,214,851,292,799,344,128,97,95,127,94,99,109,87,101,107,99,34.501614639397204,201909
向島店,1028,841,187,758,270,718,310,96,86,99,97,80,101,95,114,92,84,84,34.054696789536266,201909
君津店,1089,898,191,810,279,762,327,104,103,110,114,77,79,86,118,106,101,91,35.301781737193764,201909
和光店,1290,1056,234,934,356,902,388,111,126,115,131,121,126,113,118,111,111,107,34.834280303030305,201909
品川店,1433,1175,258,1016,417,1003,430,128,144,140,121,129,125,135,127,161,114,109,34.59744680851064,201909
四街道店,814,673,141,609,205,569,245,75,78,67,71,80,72,88,67,71,71,74,34.478454680534924,201909
国分寺店,975,777,198,748,227,682,293,92,112,77,75,73,89,86,105,74,94,98,34.81338481338481,201909
国立店,1351,1134,217,987,364,944,407,121,115,123,133,124,117,124,104,142,133,115,34.642857142857146,201909
坂戸店,1150,915,235,865,285,806,344,111,135,93,102,100,95,105,106,94,98,111,34.144262295081965,201909
墨田店,972,805,167,731,241,679,293,86,108,99,71,75,93,96,80,104,68,92,35.283229813664605,201909
多摩店,1050,869,181,763,287,738,312,99,110,95,111,106,93,79,99,79,89,90,33.949367088607595,201909
大久保店,1032,849,183,770,262,719,313,92,105,100,100,92,79,85,100,96,99,84,34.57597173144876,201909
大井店,1171,946,225,849,322,821,350,121,91,123,101,112,97,109,99,117,99,102,34.88900634249472,201909
大和店,1323,1078,245,1014,309,925,398,132,112,114,102,123,146,114,126,104,121,129,34.775510204081634,201909
大塚店,1091,894,197,782,309,763,328,90,96,82,114,96,100,102,86,99,111,115,34.0503355704698,201909
大宮店,1316,1065,251,978,338,919,397,120,136,126,133,129,102,123,130,105,99,113,34.8112676056338,201909
大森店,1386,1129,257,1038,348,971,415,132,131,105,125,117,115,130,133,130,142,126,34.70327723649247,201909
大泉店,1167,950,217,859,308,818,349,91,95,111,121,104,99,124,104,119,95,104,34.782105263157895,201909
大田店,913,733,180,702,211,640,273,102,98,79,90,94,63,70,77,81,86,73,34.7162346521146,201909
太田店,1329,1116,213,1036,293,929,400,136,102,119,124,117,109,126,141,131,116,108,34.52777777777778,201909
宇都宮店,1061,874,187,807,254,742,319,84,98,90,93,103,96,98,98,89,113,99,34.64530892448513,201909
守谷店,1143,922,221,841,302,803,340,114,97,106,102,106,99,111,116,105,94,93,34.53470715835141,201909
宮前店,697,565,132,523,174,489,208,76,67,41,71,58,68,62,64,60,69,61,34.08495575221239,201909
富岡店,1056,849,207,801,255,738,318,98,100,107,89,84,104,91,84,92,102,105,34.157832744405184,201909
富津店,997,821,176,754,243,698,299,78,85,108,88,91,84,95,93,103,71,101,34.47137637028015,201909
富里店,1447,1193,254,1065,382,1012,435,132,144,124,138,134,118,132,127,142,140,116,33.74518021793797,201909
小山店,1003,821,182,728,275,703,300,92,94,93,90,90,87,86,96,89,109,77,34.478684531059685,201909
小平店,972,784,188,730,242,682,290,87,94,84,92,103,79,97,91,86,81,78,33.9655612244898,201909
小田原店,881,718,163,656,225,618,263,95,93,74,70,86,88,75,68,82,74,76,34.004178272980496,201909
小金井店,1064,869,195,773,291,744,320,112,97,88,94,89,93,93,87,100,98,113,34.28078250863061,201909
川口店,1091,891,200,825,266,761,330,94,100,108,94,98,105,96,106,102,89,99,34.317620650953984,201909
川崎多摩店,1082,882,200,791,291,756,326,88,101,99,88,74,91,109,112,110,104,106,34.33560090702948,201909
川崎店,1178,959,219,875,303,823,355,136,110,106,111,109,93,99,87,118,99,110,46.63816475495307,201909
川越店,1119,897,222,822,297,786,333,101,94,107,109,87,106,103,97,108,104,103,47.355629877369005,201909
巣鴨店,1469,1164,305,1102,367,1026,443,143,150,122,126,140,135,131,132,134,117,139,34.877147766323034,201909
市原店,1145,931,214,844,301,803,342,102,108,96,107,124,104,99,101,103,97,104,35.16970998925886,201909
市川店,1143,931,212,873,270,801,342,99,100,106,117,110,95,111,95,98,103,109,47.48012889366273,201909
平塚店,1156,951,205,845,311,807,349,106,87,109,101,104,99,105,107,105,114,119,34.98738170347003,201909
幸店,1387,1145,242,1058,329,969,418,112,130,128,121,133,133,148,92,123,137,130,33.7825327510917,201909
府中店,1204,983,221,878,326,844,360,109,114,115,102,113,105,88,113,111,116,118,34.190233977619535,201909
座間店,1319,1087,232,980,339,924,395,124,124,133,127,109,120,113,112,122,118,117,34.3440662373505,201909
志木店,885,723,162,636,249,619,266,82,78,75,81,78,75,75,81,87,88,85,34.72199170124481,201909
恵比寿店,1002,803,199,715,287,700,302,103,80,94,81,83,85,89,85,106,92,104,20.175591531755927,201909
愛甲店,1014,820,194,782,232,706,308,107,73,88,83,88,82,98,109,87,97,102,35.19146341463415,201909
成城店,1315,1063,252,980,335,921,394,134,127,119,109,124,126,112,133,105,112,114,34.20413922859831,201909
成田店,851,683,168,658,193,595,256,84,69,76,83,70,95,76,79,64,83,72,34.30746705710102,201909
我孫子店,1090,897,193,798,292,760,330,123,77,101,103,105,93,100,105,76,99,108,20.10813823857302,201909
戸塚店,1489,1227,262,1093,396,1045,444,130,145,138,134,125,139,125,132,140,127,154,34.87612061939689,201909
戸田店,1497,1239,258,1131,366,1046,451,113,137,137,138,149,143,133,150,137,123,137,34.84826472962066,201909
所沢店,1148,912,236,855,293,803,345,94,128,90,109,86,105,114,104,106,107,105,34.0515350877193,201909
新宿店,1051,855,196,795,256,737,314,90,103,99,101,92,111,93,98,93,78,93,34.486549707602336,201909
新座店,1004,795,209,720,284,701,303,84,100,93,100,92,96,99,82,84,87,87,34.516981132075465,201909
日本橋店,1402,1137,265,1064,338,981,421,113,139,116,132,129,110,152,132,111,137,131,34.50219876868953,201909
日立店,1268,1054,214,925,343,887,381,125,112,101,116,120,117,109,123,123,109,113,34.17931688804554,201909
日野店,1124,927,197,819,305,786,338,86,92,103,113,109,99,110,101,96,100,115,34.691477885652645,201909
旭店,1208,1001,207,877,331,844,364,112,99,115,105,101,106,106,114,124,108,118,34.43656343656344,201909
春日部店,1145,924,221,867,278,798,347,110,102,96,108,94,116,101,116,105,99,98,34.63311688311689,201909
昭島店,1171,954,217,862,309,823,348,111,107,95,110,98,98,118,116,105,97,116,34.590146750524106,201909
木更津店,1080,886,194,795,285,753,327,97,90,97,96,106,91,116,89,100,103,95,34.630925507900685,201909
本庄店,1147,940,207,848,299,800,347,96,91,121,120,97,86,95,99,123,103,116,34.72446808510638,201909
本郷店,737,589,148,538,199,516,221,61,66,62,78,58,72,64,57,69,68,82,47.55687606112054,201909
杉並店,1207,984,223,929,278,845,362,121,97,105,117,95,97,112,120,118,109,116,34.01016260162601,201909
東中野店,1382,1125,257,999,383,966,416,135,114,145,124,113,114,138,127,127,124,121,34.82933333333333,201909
東久留米店,856,696,160,644,212,598,258,69,72,82,84,82,87,74,69,69,91,77,34.36350574712644,201909
東大和店,1056,862,194,774,282,742,314,103,84,81,96,91,94,106,99,109,107,86,33.990719257540604,201909
東尾久店,1172,964,208,855,317,822,350,120,87,101,115,112,116,103,97,93,116,112,33.67842323651453,201909
東村山店,1032,840,192,767,265,723,309,81,101,79,94,108,98,92,90,93,89,107,34.70476190476189,201909
東松山店,1299,1042,257,954,345,908,391,125,137,112,119,111,118,138,112,122,111,94,34.44145873320537,201909
松戸店,1207,1001,206,870,337,846,361,100,99,121,116,108,81,113,115,125,115,114,34.106893106893104,201909
板橋店,1059,896,163,780,279,741,318,95,93,80,90,112,92,85,118,100,96,98,48.800223214285715,201909
柏店,1473,1184,289,1086,387,1032,441,122,136,136,139,130,127,134,139,136,131,143,35.2018581081081,201909
栃木店,1059,857,202,786,273,737,322,101,91,79,118,100,88,86,103,84,95,114,34.046674445740955,201909
栄店,1536,1283,253,1091,445,1074,462,141,151,135,140,150,119,156,137,144,139,124,20.43725643024162,201909
桐生店,1207,974,233,882,325,844,363,92,116,98,102,100,119,93,105,113,132,137,34.90041067761807,201909
横浜南店,1375,1148,227,1024,351,963,412,136,134,134,141,120,130,114,110,114,113,129,34.35975609756097,201909
横浜緑店,1262,1046,216,903,359,884,378,109,116,122,117,117,134,119,105,101,114,108,34.33460803059273,201909
横須賀店,1065,886,179,809,256,746,319,98,90,99,91,96,78,101,108,100,87,117,34.37133182844244,201909
武蔵村山店,1263,1045,218,951,312,884,379,107,108,123,101,131,103,100,130,113,127,120,35.159808612440195,201909
武蔵野店,1059,871,188,784,275,742,317,97,87,90,98,91,89,99,109,107,112,80,35.06084959816303,201909
水戸店,1361,1111,250,1021,340,955,406,128,139,112,127,115,117,110,116,137,125,135,34.51125112511251,201909
江戸川店,1142,924,218,847,295,798,344,120,98,100,107,100,102,96,111,101,115,92,33.9448051948052,201909
江東店,1202,958,244,885,317,841,361,104,117,110,105,101,101,109,121,121,111,102,34.091858037578284,201909
池尻店,1174,963,211,849,325,823,351,101,115,95,116,111,94,123,123,101,95,100,34.0944963655244,201909
池袋店,1412,1153,259,1070,342,990,422,112,123,140,132,126,141,127,127,127,122,135,34.43625325238509,201909
泉店,1438,1165,273,1074,364,1007,431,131,143,137,144,127,142,139,116,134,120,105,33.78884120171673,201909
流山店,1465,1188,277,1061,404,1027,438,124,144,126,118,113,156,139,123,139,134,149,33.85858585858586,201909
浅草店,1349,1082,267,996,353,944,405,117,135,140,123,122,112,123,113,113,148,103,34.584103512014785,201909
浦和店,1266,1042,224,930,336,884,382,100,107,108,99,144,120,115,117,116,126,114,34.329174664107484,201909
浦安店,1290,1062,228,956,334,904,386,121,130,106,127,109,111,118,121,113,111,123,35.02071563088512,201909
海老名店,1148,933,215,826,322,804,344,120,117,107,88,105,92,116,112,102,100,89,34.07609860664523,201909
清瀬店,1033,844,189,755,278,723,310,96,108,90,102,86,100,108,88,83,76,96,35.181279620853076,201909
渋谷店,1124,917,207,828,296,786,338,102,80,101,89,87,102,95,146,99,112,111,34.01526717557252,201909
港北店,1001,831,170,739,262,698,303,92,86,96,93,102,102,90,91,91,83,75,19.945848375451266,201909
港南店,1203,969,234,915,288,844,359,131,116,106,107,102,102,116,88,111,120,104,34.14447884416925,201909
瀬谷店,1416,1160,256,1081,335,988,428,155,133,117,128,133,130,129,118,115,120,138,34.550862068965515,201909
熊谷店,1092,901,191,834,258,765,327,91,89,102,104,85,86,109,76,118,120,112,33.51276359600444,201909
狛江店,1200,995,205,877,323,841,359,111,116,101,89,106,131,115,113,118,97,103,34.699497487437185,201909
狭山店,1387,1125,262,1009,378,968,419,113,124,106,152,115,114,138,134,124,136,131,34.624,201909
王子店,1116,933,183,796,320,783,333,101,98,106,99,121,94,109,106,93,90,99,20.30117899249732,201909
町田店,1291,1074,217,982,309,902,389,107,130,118,116,117,127,109,119,101,108,139,34.431098696461824,201909
白井店,1060,877,183,770,290,742,318,116,92,95,97,91,81,95,85,99,104,105,48.27708095781072,201909
目黒店,1180,968,212,857,323,823,357,107,103,109,111,129,108,106,124,95,101,87,34.290289256198356,201909
相模原店,1439,1183,256,1070,369,1008,431,137,144,138,121,121,130,139,128,125,134,122,33.938292476754015,201909
石神井店,935,782,153,692,243,655,280,76,75,100,101,77,79,81,95,89,76,86,48.58951406649615,201909
磯子店,908,748,160,664,244,635,273,78,81,70,86,78,95,75,83,92,79,91,33.8168449197861,201909
神奈川店,1347,1096,251,1006,341,942,405,117,121,109,128,136,138,116,132,114,117,119,34.96715328467153,201909
神田店,1415,1149,266,1087,328,993,422,114,129,141,127,151,132,153,114,120,109,125,34.61357702349869,201909
福生店,1320,1079,241,961,359,928,392,113,123,141,124,110,126,111,120,118,127,107,34.253012048192765,201909
秦野店,1210,971,239,868,342,845,365,121,122,105,115,118,98,125,94,118,94,100,33.93305870236869,201909
稲城店,939,754,185,678,261,655,284,71,98,78,81,85,79,83,100,105,78,81,46.3501326259947,201909
立川店,1266,1026,240,919,347,883,383,131,106,108,113,120,122,114,115,113,125,99,35.50682261208577,201909
綾瀬店,2625,2146,479,1951,674,1836,789,240,251,230,236,244,263,249,243,223,226,220,34.47157502329916,201909
練馬店,1377,1107,270,1008,369,962,415,121,114,121,145,116,133,129,124,118,138,118,34.24932249322493,201909
羽村店,1352,1108,244,1015,337,948,404,131,102,120,126,122,121,117,143,122,107,141,19.85649819494585,201909
羽生店,1291,1061,230,989,302,904,387,108,121,109,111,124,103,120,127,125,121,122,34.61262959472196,201909
習志野店,1380,1110,270,999,381,964,416,124,120,116,143,134,136,119,122,112,138,116,35.06666666666667,201909
自由が丘店,1268,1047,221,918,350,887,381,135,104,113,120,106,129,125,115,101,111,109,35.071633237822354,201909
船橋店,1437,1166,271,1078,359,1005,432,126,117,128,130,122,151,134,123,155,114,137,35.2590051457976,201909
若葉店,1144,946,198,847,297,803,341,111,117,98,107,102,108,101,116,99,96,89,34.989429175475685,201909
茂原店,1330,1105,225,982,348,929,401,132,126,110,118,122,115,115,100,114,150,128,34.14298642533937,201909
茅ヶ崎店,884,713,171,649,235,619,265,78,79,85,82,62,80,96,86,79,81,76,34.22440392706872,201909
草加店,968,796,172,729,239,679,289,99,70,90,73,96,90,84,91,93,87,95,35.104271356783926,201909
荒川店,881,723,158,674,207,615,266,68,78,92,79,77,84,81,77,86,74,85,34.04979253112033,201909
荻窪店,1203,982,221,882,321,846,357,99,96,114,98,87,102,119,135,118,120,115,19.80244399185336,201909
葛飾店,1116,906,210,838,278,779,337,101,76,102,114,105,102,103,111,107,90,105,35.0121412803532,201909
蒲田店,988,790,198,726,262,689,299,89,95,92,94,90,81,112,80,81,81,93,33.6126582278481,201909
藤沢店,1153,933,220,870,283,809,344,113,102,119,117,115,100,105,88,90,96,108,34.30117899249732,201909
行田店,977,809,168,724,253,685,292,102,88,84,96,79,97,84,86,85,92,84,34.47836835599506,201909
西多摩店,1531,1242,289,1127,404,1075,456,135,134,131,164,138,148,139,130,139,143,130,34.20209339774557,201909
西東京店,966,792,174,704,262,674,292,87,89,98,72,86,77,101,89,104,89,74,34.513888888888886,201909
西葛西店,792,675,117,559,233,553,239,85,82,73,75,46,79,69,72,79,62,70,34.08444444444444,201909
調布店,1385,1132,253,1046,339,971,414,122,134,127,129,122,119,116,119,141,118,138,33.76855123674912,201909
谷中店,1504,1228,276,1116,388,1052,452,144,155,131,146,121,133,133,124,141,148,128,34.903094462540714,201909
赤坂店,1002,800,202,757,245,699,303,100,94,101,81,93,100,85,90,68,108,82,34.7575,201909
赤羽店,1142,947,195,854,288,801,341,98,108,99,118,104,108,91,108,97,106,105,46.82893347412882,201909
越谷店,875,707,168,662,213,614,261,75,73,68,64,85,78,87,90,99,78,78,48.02404526166902,201909
足利店,790,657,133,574,216,549,241,62,84,69,74,73,73,58,78,68,69,82,34.54946727549467,201909
足柄上店,1206,967,239,897,309,842,364,109,107,96,121,107,108,114,119,104,113,108,33.79834539813857,201909
足立店,862,704,158,625,237,603,259,79,71,81,75,77,95,83,72,73,85,71,34.30681818181818,201909
逗子店,1062,900,162,807,255,742,320,105,87,95,98,95,114,94,87,101,84,102,34.75333333333333,201909
那珂店,1171,961,210,858,313,819,352,87,100,122,102,109,106,98,107,94,107,139,20.304890738813725,201909
都筑店,1009,823,186,754,255,708,301,84,98,89,91,88,104,75,95,97,87,101,34.91373025516403,201909
金沢店,1232,987,245,898,334,861,371,110,100,108,108,106,118,123,113,111,117,118,20.515704154002027,201909
銀座店,969,794,175,732,237,684,285,81,85,84,76,96,99,85,89,90,88,96,34.88287153652393,201909
鎌倉店,968,773,195,683,285,680,288,91,91,70,84,81,107,78,88,94,70,114,34.23156532988357,201909
青山店,1328,1100,228,957,371,929,399,119,103,122,130,134,110,123,129,127,116,115,34.121818181818185,201909
青梅店,1235,1000,235,898,337,867,368,95,108,116,109,95,130,115,120,117,109,121,35.126999999999995,201909
青葉店,1119,906,213,815,304,784,335,113,109,89,118,106,93,98,94,118,87,94,34.2439293598234,201909
館林店,1143,927,216,819,324,799,344,106,102,101,122,116,104,115,95,85,93,104,33.708737864077676,201909
駒沢店,1003,828,175,743,260,700,303,89,99,86,98,89,87,84,85,107,86,93,35.04710144927536,201909
駒込店,1440,1162,278,1079,361,1010,430,127,120,130,121,134,122,115,141,140,155,135,34.70998278829604,201909
高円寺店,1376,1117,259,1031,345,959,417,139,117,134,144,127,104,129,99,101,117,165,34.923903312444054,201909
高島平店,1203,993,210,896,307,838,365,120,115,102,109,93,98,102,129,98,115,122,34.57502517623364,201909
高崎店,1115,906,209,818,297,779,336,99,98,94,99,119,108,107,96,100,96,99,34.68543046357616,201909
高座店,1113,889,224,832,281,777,336,110,97,88,96,80,112,97,124,100,109,100,33.95838020247469,201909
高津店,1112,895,217,805,307,778,334,108,100,92,106,98,104,113,93,99,97,102,35.86033519553072,201909
高田馬場店,1057,846,211,773,284,738,319,109,102,82,90,103,89,100,100,68,100,114,33.88297872340426,201909
鴻巣店,1117,924,193,827,290,784,333,107,108,92,115,103,99,107,106,82,108,90,35.574675324675326,201909
鶴見店,1472,1218,254,1069,403,1032,440,128,154,122,130,134,113,121,132,142,139,157,35.6576354679803,201909
麻生店,1349,1089,260,962,387,943,406,121,130,111,131,108,137,134,125,115,120,117,34.15518824609734,201909
あきる野店,1189,970,219,848,341,880,309,109,104,113,108,96,111,90,126,112,116,104,34.56907216494845,201910
さいたま南店,1556,1278,278,1155,401,1155,401,140,125,133,167,143,127,174,136,141,150,120,34.309076682316125,201910
さいたま緑店,1065,852,213,789,276,789,276,86,101,108,100,94,100,92,107,88,94,95,34.54694835680751,201910
さいたま西店,1212,995,217,901,311,898,314,113,103,97,105,110,99,88,105,118,128,146,34.597989949748744,201910
つくば店,1304,1066,238,965,339,967,337,123,116,129,89,121,103,128,134,107,120,134,34.991557223264536,201910
三浦店,1184,990,194,898,286,876,308,117,97,91,102,133,114,96,119,110,101,104,34.95353535353535,201910
三鷹店,1552,1245,307,1142,410,1153,399,130,135,117,141,167,151,136,161,138,120,156,34.53172690763052,201910
上尾店,1364,1103,261,1006,358,1015,349,121,128,110,123,127,139,128,128,134,124,102,19.8467815049864,201910
上野店,1681,1341,340,1232,449,1250,431,150,174,135,149,152,161,142,180,149,158,131,33.95152870991797,201910
世田谷店,1579,1291,288,1169,410,1174,405,119,132,154,140,157,139,134,146,141,175,142,34.003098373353986,201910
中原店,1583,1277,306,1168,415,1176,407,166,130,148,138,121,162,136,162,135,136,149,34.692247454972595,201910
中店,1243,1001,242,958,285,923,320,122,122,120,108,127,87,115,128,85,108,121,34.706293706293714,201910
中野店,1188,970,218,884,304,880,308,117,100,115,100,86,111,100,113,108,101,137,34.12577319587629,201910
久喜店,1333,1109,224,975,358,990,343,132,111,133,115,99,122,129,115,128,128,121,34.805229936880075,201910
九段店,1371,1126,245,1029,342,1019,352,133,106,115,125,118,119,135,122,147,126,125,34.31527531083481,201910
亀有店,1059,839,220,779,280,790,269,119,88,102,103,79,94,96,89,93,107,89,35.04290822407628,201910
五反田店,1192,945,247,882,310,884,308,117,108,102,120,96,102,130,103,97,117,100,35.3989417989418,201910
代々木店,1392,1145,247,1028,364,1029,363,124,134,139,130,138,114,141,134,107,105,126,34.51877729257643,201910
伊勢原店,1493,1212,281,1110,383,1111,382,126,139,147,132,118,149,125,145,153,134,125,35.06848184818482,201910
伊勢崎店,1641,1325,316,1231,410,1217,424,156,149,151,140,132,155,159,158,150,143,148,34.00754716981132,201910
佐倉店,906,734,172,692,214,671,235,71,92,84,88,82,70,92,88,78,83,78,33.72479564032697,201910
佐野店,1562,1273,289,1144,418,1161,401,131,171,119,148,146,157,147,131,138,146,128,34.4076983503535,201910
保土ケ谷店,1306,1055,251,971,335,967,339,114,124,130,116,111,136,103,111,127,104,130,35.28056872037915,201910
入間店,1187,968,219,887,300,879,308,104,99,102,111,110,115,115,120,112,112,87,34.335743801652896,201910
八千代店,1281,1054,227,957,324,953,328,124,119,110,98,104,121,125,118,141,114,107,34.95635673624288,201910
八潮店,1252,1023,229,944,308,930,322,119,120,110,123,121,100,104,119,112,112,112,34.08895405669599,201910
八王子店,1580,1260,320,1188,392,1174,406,148,161,147,133,162,144,142,123,136,145,139,34.48015873015873,201910
六本木店,1027,831,196,781,246,760,267,106,80,105,82,80,89,113,93,82,101,96,34.269554753309265,201910
前橋店,856,710,146,625,231,636,220,77,87,79,73,90,67,72,84,71,77,79,34.37887323943662,201910
北千住店,1031,828,203,764,267,763,268,98,76,107,74,97,91,104,86,90,103,105,34.772946859903385,201910
千葉中央店,1307,1085,222,940,367,969,338,114,125,114,112,121,118,112,132,117,120,122,33.89585253456221,201910
千葉緑店,1188,978,210,891,297,882,306,108,95,103,115,126,121,112,105,97,108,98,34.7280163599182,201910
南砂店,1297,1076,221,954,343,963,334,129,122,122,114,115,128,122,112,91,123,119,34.726765799256505,201910
南足柄店,1036,840,196,758,278,768,268,103,79,98,103,104,79,92,100,92,86,100,33.644047619047626,201910
厚木店,1493,1197,296,1094,399,1111,382,139,142,145,133,135,145,128,111,148,140,127,35.02422723475355,201910
取手店,1173,966,207,874,299,874,299,103,95,107,102,106,111,97,101,144,96,111,34.334368530020704,201910
向島店,1066,876,190,776,290,790,276,104,87,90,90,97,102,110,97,94,92,103,34.8458904109589,201910
君津店,1134,928,206,857,277,843,291,111,115,102,101,99,126,109,95,75,103,98,34.35344827586207,201910
和光店,1339,1068,271,983,356,998,341,120,94,135,139,127,127,124,128,102,115,128,33.993445692883896,201910
品川店,1491,1204,287,1105,386,1107,384,124,152,116,124,150,153,141,121,137,129,144,34.235049833887054,201910
四街道店,844,681,163,626,218,626,218,66,81,64,71,73,78,77,85,89,83,77,35.15124816446402,201910
国分寺店,991,796,195,727,264,734,257,99,98,85,81,86,84,77,95,106,107,73,34.31030150753769,201910
国立店,1405,1151,254,1042,363,1042,363,139,126,122,115,133,124,140,135,142,106,123,34.29452649869678,201910
坂戸店,1192,955,237,905,287,884,308,106,107,101,94,125,122,109,108,112,102,106,34.57801047120419,201910
墨田店,997,831,166,747,250,737,260,89,99,95,85,84,94,90,98,93,89,81,34.078219013237074,201910
多摩店,1101,921,180,816,285,817,284,97,117,108,89,110,105,103,101,102,92,77,35.23018458197611,201910
大久保店,1064,866,198,777,287,787,277,93,88,97,113,101,95,102,91,85,100,99,35.25519630484988,201910
大井店,1211,962,249,902,309,898,313,130,103,98,104,113,109,123,108,118,93,112,34.597713097713104,201910
大和店,1362,1094,268,1028,334,1008,354,119,129,122,108,114,117,118,128,148,135,124,33.39488117001828,201910
大塚店,1128,942,186,862,266,835,293,94,92,108,112,114,97,107,110,88,98,108,34.781316348195325,201910
大宮店,1367,1101,266,1051,316,1012,355,131,125,121,125,116,128,123,128,122,130,118,34.93188010899183,201910
大森店,1433,1168,265,1077,356,1065,368,117,121,147,123,130,135,112,145,160,114,129,33.946917808219176,201910
大泉店,1221,988,233,908,313,906,315,126,124,106,97,98,113,110,104,119,116,108,35.20242914979757,201910
大田店,946,761,185,706,240,702,244,73,88,109,77,74,78,93,90,97,80,87,34.23127463863338,201910
太田店,1361,1126,235,1043,318,1011,350,130,126,120,133,128,140,116,129,123,101,115,34.218472468916524,201910
宇都宮店,1097,889,208,829,268,814,283,96,107,97,98,93,92,107,94,119,102,92,34.37682789651293,201910
守谷店,1188,990,198,905,283,886,302,107,94,119,93,112,110,122,102,115,101,113,34.26464646464647,201910
宮前店,729,584,145,538,191,539,190,57,60,57,83,57,82,58,61,70,72,72,34.921232876712324,201910
富岡店,1094,911,183,810,284,810,284,103,96,109,88,90,97,102,98,98,118,95,34.1569703622393,201910
富津店,1029,826,203,775,254,764,265,85,83,91,95,101,99,93,91,84,102,105,34.78692493946731,201910
富里店,1480,1217,263,1091,389,1100,380,128,128,136,133,129,133,140,134,127,147,145,34.457682826622836,201910
小山店,1041,854,187,756,285,773,268,102,84,99,105,99,95,86,99,84,85,103,34.35480093676815,201910
小平店,1010,838,172,755,255,747,263,100,99,96,90,99,90,83,77,103,95,78,35.236276849642,201910
小田原店,916,756,160,658,258,680,236,82,82,65,119,84,87,78,83,65,81,90,34.72089947089947,201910
小金井店,1097,888,209,826,271,813,284,113,79,91,109,99,87,108,111,98,108,94,33.697072072072075,201910
川口店,1124,918,206,797,327,832,292,105,108,121,93,97,103,104,102,90,104,97,33.96949891067539,201910
川崎多摩店,1125,902,223,832,293,836,289,110,117,86,87,101,114,108,110,112,94,86,34.82483370288249,201910
川崎店,1216,1002,214,912,304,902,314,115,104,112,113,102,102,106,109,117,117,119,47.581836327345314,201910
川越店,1153,931,222,857,296,854,299,94,79,125,110,88,127,112,106,104,107,101,47.43071965628357,201910
巣鴨店,1517,1242,275,1146,371,1125,392,140,134,135,137,155,144,135,138,128,133,138,34.790660225442835,201910
市原店,1179,967,212,864,315,877,302,113,124,111,106,115,83,104,109,100,103,111,34.51499482936918,201910
市川店,1187,981,206,882,305,879,308,113,107,117,116,105,93,101,114,117,101,103,47.0,201910
平塚店,1183,989,194,857,326,876,307,101,99,123,105,85,109,119,121,106,109,106,33.68655207280081,201910
幸店,1421,1146,275,1054,367,1046,375,124,125,129,153,125,122,111,123,128,140,141,33.98778359511344,201910
府中店,1254,1020,234,944,310,927,327,127,114,115,98,127,118,96,115,104,131,109,33.803921568627445,201910
座間店,1376,1106,270,1010,366,1020,356,106,118,128,139,143,124,127,120,124,116,131,34.40415913200723,201910
志木店,901,746,155,653,248,668,233,78,87,85,79,96,73,80,72,89,81,81,35.26541554959785,201910
恵比寿店,1028,859,169,791,237,765,263,81,78,98,85,96,110,94,86,102,87,111,20.728754365541327,201910
愛甲店,1065,867,198,789,276,790,275,101,102,94,102,88,90,101,83,116,88,100,34.82006920415225,201910
成城店,1370,1135,235,1011,359,1015,355,131,130,124,128,117,124,118,132,119,125,122,34.690748898678414,201910
成田店,876,695,181,646,230,653,223,75,80,87,87,73,81,90,64,92,75,72,34.68776978417266,201910
我孫子店,1129,913,216,848,281,839,290,123,87,106,96,91,108,115,96,85,125,97,20.37568455640745,201910
戸塚店,1547,1248,299,1153,394,1146,401,153,158,129,132,131,121,152,126,149,136,160,34.4823717948718,201910
戸田店,1552,1278,274,1166,386,1149,403,138,152,147,121,153,133,149,146,128,156,129,34.432707355242556,201910
所沢店,1178,970,208,868,310,876,302,103,124,114,121,111,96,102,110,100,93,104,34.69896907216495,201910
新宿店,1091,908,183,805,286,809,282,93,81,95,110,98,96,107,89,110,117,95,34.08259911894273,201910
新座店,1040,856,184,772,268,774,266,104,81,88,94,84,87,96,101,108,98,99,34.71728971962617,201910
日本橋店,1451,1154,297,1076,375,1079,372,131,134,150,127,130,131,102,154,127,128,137,34.65944540727903,201910
日立店,1311,1075,236,964,347,975,336,114,122,118,118,103,122,110,120,118,125,141,33.8893023255814,201910
日野店,1155,945,210,848,307,858,297,115,111,123,105,102,100,108,94,94,94,109,33.883597883597886,201910
旭店,1239,1010,229,913,326,915,324,91,137,115,82,113,111,117,105,137,112,119,34.635643564356435,201910
春日部店,1190,959,231,874,316,882,308,99,117,105,114,104,102,107,102,122,111,107,34.246089676746614,201910
昭島店,1205,983,222,896,309,900,305,107,102,107,100,109,124,98,129,115,109,105,34.96236012207528,201910
木更津店,1125,927,198,799,326,835,290,101,97,101,96,99,98,105,104,105,106,113,34.13052858683927,201910
本庄店,1187,958,229,892,295,879,308,115,95,107,109,97,123,115,107,106,100,113,34.463465553235906,201910
本郷店,754,624,130,566,188,558,196,73,73,79,64,70,65,64,65,73,61,67,46.10576923076921,201910
杉並店,1251,1037,214,931,320,930,321,111,117,124,130,103,106,122,102,105,112,119,34.338476374156215,201910
東中野店,1435,1161,274,1063,372,1063,372,118,127,124,128,139,119,146,146,120,124,144,35.475452196382435,201910
東久留米店,889,716,173,658,231,658,231,65,83,96,77,77,74,71,88,91,98,69,34.66201117318436,201910
東大和店,1093,889,204,809,284,810,283,124,101,104,97,99,108,101,93,93,91,82,34.224971878515184,201910
東尾久店,1218,1015,203,893,325,909,309,111,95,119,128,124,117,102,111,94,120,97,34.653201970443355,201910
東村山店,1054,885,169,779,275,783,271,100,111,107,92,91,88,101,88,93,92,91,34.49265536723164,201910
東松山店,1324,1085,239,995,329,982,342,130,117,100,118,126,118,112,120,125,116,142,33.67557603686636,201910
松戸店,1245,1031,214,931,314,925,320,124,114,103,120,103,111,104,110,108,113,135,34.57904946653734,201910
板橋店,1087,895,192,807,280,804,283,106,88,100,113,96,94,109,98,93,93,97,48.338547486033534,201910
柏店,1524,1260,264,1132,392,1132,392,111,141,130,131,132,131,161,150,144,135,158,34.82301587301588,201910
栃木店,1096,897,199,814,282,812,284,99,76,87,93,107,95,125,117,96,95,106,35.41248606465998,201910
栄店,1566,1279,287,1135,431,1159,407,155,111,139,139,136,150,139,159,130,153,155,20.083659108678656,201910
桐生店,1239,1022,217,911,328,922,317,103,115,104,101,120,106,110,122,122,119,117,34.93737769080235,201910
横浜南店,1422,1171,251,1040,382,1051,371,138,135,109,130,118,136,120,118,145,137,136,34.51067463706234,201910
横浜緑店,1310,1056,254,975,335,977,333,127,132,109,124,137,112,112,116,101,117,123,34.49147727272727,201910
横須賀店,1100,915,185,813,287,817,283,117,85,116,105,104,89,98,101,74,93,118,35.479781420765036,201910
武蔵村山店,1315,1077,238,973,342,975,340,113,111,110,98,135,131,121,121,117,113,145,35.10770659238626,201910
武蔵野店,1088,875,213,779,309,806,282,103,101,99,116,78,113,99,90,90,95,104,33.69828571428572,201910
水戸店,1396,1128,268,1033,363,1037,359,110,146,118,112,130,126,124,154,133,114,129,35.09574468085106,201910
江戸川店,1189,952,237,878,311,883,306,101,103,100,95,129,109,95,113,113,114,117,33.79621848739496,201910
江東店,1253,1003,250,925,328,928,325,117,96,121,121,112,120,124,102,116,120,104,35.11864406779661,201910
池尻店,1214,1002,212,901,313,902,312,118,107,100,106,114,123,122,112,93,101,118,33.62674650698603,201910
池袋店,1459,1171,288,1087,372,1084,375,147,128,135,138,124,139,122,128,133,136,129,35.50213492741247,201910
泉店,1486,1195,291,1096,390,1103,383,142,125,129,135,147,128,149,129,143,138,121,33.620920502092055,201910
流山店,1521,1231,290,1108,413,1130,391,139,145,151,140,139,122,138,137,138,141,131,34.74004874086109,201910
浅草店,1405,1157,248,1008,397,1042,363,150,115,125,132,105,128,136,124,133,123,134,34.738115816767504,201910
浦和店,1307,1062,245,958,349,970,337,104,121,112,125,108,126,129,107,122,131,122,34.74858757062147,201910
浦安店,1339,1091,248,1001,338,991,348,113,125,122,133,149,129,115,111,104,122,116,34.872593950504125,201910
海老名店,1191,976,215,868,323,885,306,104,115,95,120,93,111,104,107,128,96,118,35.28176229508197,201910
清瀬店,1070,867,203,787,283,796,274,92,112,81,81,109,99,91,106,100,97,102,33.62975778546713,201910
渋谷店,1156,965,191,849,307,856,300,104,104,106,94,109,101,103,108,108,121,98,34.22072538860104,201910
港北店,1019,833,186,759,260,755,264,82,91,112,87,88,101,87,92,93,105,81,20.352941176470583,201910
港南店,1240,1020,220,920,320,917,323,115,97,104,111,125,107,131,102,121,118,109,34.937254901960785,201910
瀬谷店,1457,1181,276,1095,362,1079,378,118,147,127,122,134,128,160,133,138,128,122,34.01608806096528,201910
熊谷店,1122,918,204,842,280,833,289,85,110,95,108,102,100,114,98,116,85,109,34.57843137254902,201910
狛江店,1244,1011,233,917,327,921,323,106,90,131,147,111,125,110,90,115,116,103,34.59149357072206,201910
狭山店,1434,1150,284,1080,354,1063,371,139,135,137,117,107,128,134,122,132,150,133,34.75826086956522,201910
王子店,1149,926,223,823,326,852,297,112,105,102,114,106,94,114,121,107,83,91,21.137149028077754,201910
町田店,1335,1068,267,990,345,991,344,110,101,136,118,139,101,114,136,121,117,142,35.043071161048694,201910
白井店,1087,879,208,801,286,806,281,103,106,100,108,104,96,90,85,95,105,95,47.769055745164955,201910
目黒店,1212,984,228,922,290,900,312,136,109,92,119,116,100,100,101,98,109,132,34.175813008130085,201910
相模原店,1490,1208,282,1102,388,1108,382,130,135,126,135,138,136,126,152,144,135,133,34.31705298013245,201910
石神井店,968,794,174,705,263,717,251,94,88,101,78,94,96,102,89,75,87,64,46.62846347607053,201910
磯子店,945,782,163,708,237,701,244,96,75,79,85,98,82,86,79,97,72,96,33.975703324808194,201910
神奈川店,1407,1165,242,1055,352,1048,359,122,137,133,138,140,123,120,124,109,138,123,33.75021459227468,201910
神田店,1458,1218,240,1073,385,1084,374,134,145,143,127,142,131,115,117,141,131,132,34.53858784893268,201910
福生店,1365,1123,242,1023,342,1013,352,126,118,124,122,126,121,122,128,125,127,126,33.84327693677649,201910
秦野店,1242,988,254,907,335,923,319,108,102,106,106,115,138,107,132,103,115,110,34.96255060728745,201910
稲城店,972,805,167,704,268,719,253,78,95,86,95,83,102,71,73,87,101,101,48.47701863354038,201910
立川店,1307,1051,256,974,333,971,336,112,136,122,108,116,120,118,118,102,136,119,35.174119885823025,201910
綾瀬店,2698,2189,509,1966,732,2004,694,226,251,247,259,229,264,263,254,242,217,246,34.136592051164925,201910
練馬店,1432,1172,260,1029,403,1061,371,139,119,119,142,97,145,137,128,134,146,126,34.7858361774744,201910
羽村店,1397,1123,274,1044,353,1043,354,143,127,140,107,128,130,107,116,134,139,126,20.348174532502227,201910
羽生店,1339,1088,251,997,342,989,350,119,119,113,144,110,112,107,129,135,115,136,34.42095588235294,201910
習志野店,1426,1163,263,1036,390,1056,370,122,129,131,141,135,125,121,129,139,124,130,34.129836629406704,201910
自由が丘店,1303,1068,235,973,330,969,334,121,126,118,134,107,104,118,118,124,112,121,35.0252808988764,201910
船橋店,1495,1201,294,1118,377,1109,386,126,127,133,132,134,132,151,131,133,134,162,34.72439633638634,201910
若葉店,1185,957,228,873,312,877,308,104,117,109,102,115,108,116,121,102,93,98,34.523510971786834,201910
茂原店,1368,1131,237,1012,356,1013,355,122,127,132,126,125,134,128,135,127,104,108,34.09372236958444,201910
茅ヶ崎店,923,767,156,671,252,685,238,90,77,83,88,92,72,83,82,92,84,80,34.220338983050844,201910
草加店,1000,787,213,750,250,740,260,87,78,91,111,90,91,107,81,91,93,80,35.37992376111817,201910
荒川店,911,727,184,673,238,677,234,82,78,86,75,87,100,74,80,79,87,83,34.87207702888582,201910
荻窪店,1251,1028,223,930,321,929,322,137,106,114,98,114,108,116,122,101,116,119,20.79377431906615,201910
葛飾店,1148,943,205,838,310,853,295,106,90,104,109,92,108,124,111,94,109,101,35.26723223753977,201910
蒲田店,1037,842,195,761,276,771,266,92,91,96,94,90,97,108,91,89,96,93,34.00593824228029,201910
藤沢店,1180,959,221,860,320,876,304,93,101,116,115,89,113,107,108,107,113,118,34.24713242961418,201910
行田店,1001,813,188,746,255,741,260,113,87,87,94,89,96,76,90,109,81,79,34.61008610086101,201910
西多摩店,1579,1270,309,1176,403,1171,408,140,126,125,158,174,136,142,157,142,150,129,34.31338582677165,201910
西東京店,1001,815,186,746,255,743,258,88,92,95,100,99,84,81,87,81,100,94,35.35705521472393,201910
西葛西店,821,680,141,618,203,606,215,67,68,71,77,77,75,76,72,80,74,84,34.686764705882354,201910
調布店,1428,1175,253,1052,376,1061,367,108,127,127,140,125,149,113,128,133,137,141,34.982127659574466,201910
谷中店,1544,1233,311,1132,412,1147,397,157,150,132,154,157,116,137,119,138,143,141,34.78102189781022,201910
赤坂店,1035,835,200,768,267,766,269,94,105,89,81,79,102,108,94,87,93,103,34.11616766467065,201910
赤羽店,1186,988,198,882,304,876,310,112,118,126,118,110,103,94,98,119,109,79,48.51012145748988,201910
越谷店,904,719,185,676,228,670,234,81,77,82,79,77,96,99,83,71,75,84,47.27260083449235,201910
足利店,817,673,144,615,202,608,209,73,86,65,71,71,78,72,84,70,80,67,34.25705794947994,201910
足柄上店,1241,1003,238,921,320,919,322,103,112,102,96,134,117,94,120,122,117,124,34.65304087736789,201910
足立店,881,716,165,657,224,651,230,82,89,94,68,70,73,89,70,101,72,73,34.45949720670391,201910
逗子店,1090,841,249,779,311,810,280,92,100,82,93,97,100,116,93,114,99,104,33.93222354340072,201910
那珂店,1208,969,239,907,301,896,312,97,120,114,113,125,117,120,89,106,106,101,20.25180598555212,201910
都筑店,1025,842,183,773,252,760,265,87,98,95,84,88,102,96,99,89,98,89,34.92399049881235,201910
金沢店,1271,1025,246,969,302,940,331,115,118,113,107,99,122,111,126,129,127,104,20.237073170731712,201910
銀座店,999,814,185,788,211,739,260,97,83,97,88,90,82,86,97,95,84,100,35.19164619164619,201910
鎌倉店,1004,802,202,753,251,745,259,96,112,88,91,95,66,115,82,96,80,83,35.30299251870324,201910
青山店,1363,1117,246,1009,354,1013,350,109,121,112,117,135,125,141,140,124,137,102,34.09579230080573,201910
青梅店,1277,1029,248,949,328,945,332,108,116,129,104,129,122,106,125,125,102,111,34.48299319727891,201910
青葉店,1149,946,203,843,306,854,295,129,105,102,112,101,102,111,103,89,89,106,34.17441860465117,201910
館林店,1189,945,244,882,307,878,311,124,97,107,116,119,96,106,103,108,106,107,34.68888888888889,201910
駒沢店,1034,855,179,762,272,768,266,91,82,85,104,102,91,84,85,100,92,118,34.122807017543856,201910
駒込店,1497,1228,269,1083,414,1108,389,152,126,149,129,146,146,145,119,127,126,132,34.251628664495115,201910
高円寺店,1429,1163,266,1076,353,1059,370,141,131,134,124,120,125,114,143,140,130,127,34.3731728288908,201910
高島平店,1244,1036,208,934,310,920,324,92,123,110,111,141,111,104,120,109,111,112,35.27606177606177,201910
高崎店,1145,936,209,841,304,852,293,118,115,107,95,123,86,108,90,88,112,103,34.19230769230769,201910
高座店,1150,944,206,849,301,853,297,117,109,98,90,114,105,92,110,97,106,112,34.71292372881356,201910
高津店,1152,925,227,854,298,853,299,116,97,90,92,110,101,109,114,96,107,120,34.688648648648645,201910
高田馬場店,1098,896,202,806,292,819,279,80,94,90,107,112,96,100,111,88,115,105,35.27455357142857,201910
鴻巣店,1163,910,253,855,308,864,299,102,112,112,102,105,98,112,101,113,100,106,35.518681318681324,201910
鶴見店,1519,1273,246,1135,384,1126,393,139,154,141,136,148,128,148,140,130,130,125,34.48860958366065,201910
麻生店,1395,1170,225,1021,374,1037,358,117,115,130,131,131,133,125,130,115,126,142,34.044444444444444,201910
あきる野店,1137,943,194,853,284,796,341,84,105,102,93,107,92,104,117,111,118,104,34.513255567338284,201911
さいたま南店,1508,1243,265,1110,398,1055,453,150,139,139,132,127,117,130,132,135,161,146,34.276749798873695,201911
さいたま緑店,1027,837,190,740,287,719,308,74,75,114,98,94,101,93,92,109,85,92,34.51135005973716,201911
さいたま西店,1176,947,229,873,303,823,353,123,106,107,113,110,95,94,101,119,108,100,33.91657866948257,201911
つくば店,1258,1041,217,935,323,880,378,115,118,127,117,125,110,99,123,110,108,106,34.23823246878002,201911
三浦店,1128,917,211,842,286,797,331,111,89,96,90,115,92,120,104,97,109,105,34.63358778625954,201911
三鷹店,1497,1203,294,1123,374,1048,449,148,152,125,136,135,119,131,143,120,143,145,34.43557772236076,201911
上尾店,1318,1085,233,990,328,917,401,121,118,120,126,139,115,118,131,96,110,124,20.327188940092167,201911
上野店,1618,1307,311,1183,435,1135,483,161,150,147,133,146,134,157,162,157,143,128,34.43611323641928,201911
世田谷店,1524,1254,270,1135,389,1069,455,138,125,143,130,129,142,126,138,153,146,154,34.74322169059011,201911
中原店,1528,1230,298,1131,397,1068,460,140,138,129,128,118,162,140,133,134,151,155,33.98211382113821,201911
中店,1211,977,234,892,319,845,366,126,119,97,120,114,120,92,88,115,97,123,34.7093142272262,201911
中野店,1149,963,186,852,297,804,345,90,117,89,100,90,98,125,114,116,110,100,34.12772585669782,201911
久喜店,1297,1041,256,975,322,906,391,112,122,114,141,110,114,118,109,98,143,116,34.434197886647446,201911
九段店,1319,1068,251,1013,306,923,396,114,116,115,105,141,119,134,128,116,128,103,34.53651685393257,201911
亀有店,1032,835,197,767,265,721,311,115,85,90,77,75,96,106,92,117,96,83,34.7245508982036,201911
五反田店,1148,945,203,861,287,803,345,108,111,115,103,103,97,93,110,97,100,111,34.663492063492065,201911
代々木店,1360,1093,267,1026,334,954,406,121,127,121,102,133,118,129,130,121,123,135,35.0128087831656,201911
伊勢原店,1439,1181,258,1065,374,1015,424,126,142,113,132,126,133,123,150,129,122,143,34.171888230313286,201911
伊勢崎店,1585,1321,264,1180,405,1108,477,130,141,157,143,142,147,148,136,143,159,139,34.27933383800151,201911
佐倉店,884,752,132,655,229,621,263,79,73,77,92,69,88,67,86,77,93,83,33.86436170212766,201911
佐野店,1489,1219,270,1124,365,1039,450,129,128,135,153,145,130,128,141,125,144,131,33.80803937653815,201911
保土ケ谷店,1264,1054,210,953,311,890,374,114,112,124,116,110,104,129,111,129,109,106,34.12998102466793,201911
入間店,1141,935,206,851,290,803,338,104,100,103,122,93,86,93,99,120,105,116,35.1807486631016,201911
八千代店,1236,1004,232,920,316,862,374,101,101,108,118,105,116,106,104,129,122,126,34.385458167330675,201911
八潮店,1203,949,254,857,346,840,363,113,127,71,113,109,99,111,124,126,115,95,34.77660695468914,201911
八王子店,1526,1235,291,1125,401,1071,455,144,133,130,149,137,147,127,136,154,132,137,34.66720647773279,201911
六本木店,1010,832,178,782,228,709,301,88,97,89,91,88,90,89,108,96,92,82,34.638221153846146,201911
前橋店,814,680,134,617,197,571,243,83,72,65,71,49,91,78,67,71,87,80,33.811764705882354,201911
北千住店,997,818,179,752,245,696,301,69,89,105,106,84,87,82,102,92,87,94,35.16748166259169,201911
千葉中央店,1265,1044,221,929,336,887,378,113,116,98,110,114,114,136,133,96,110,125,34.606321839080465,201911
千葉緑店,1141,935,206,861,280,797,344,101,108,76,120,84,96,123,100,118,112,103,34.64919786096257,201911
南砂店,1260,1041,219,956,304,884,376,120,100,111,126,120,114,113,120,106,125,105,34.60134486071085,201911
南足柄店,999,806,193,727,272,699,300,82,90,99,87,100,88,90,91,97,88,87,33.88089330024814,201911
厚木店,1438,1159,279,1069,369,1005,433,137,124,134,139,132,129,116,139,123,138,127,34.923209663503016,201911
取手店,1144,937,207,859,285,803,341,97,110,100,124,107,111,77,101,103,110,104,34.110992529348984,201911
向島店,1037,857,180,772,265,726,311,107,89,97,100,99,100,105,85,70,93,92,35.26487747957993,201911
君津店,1091,897,194,798,293,764,327,80,113,106,108,106,88,97,91,102,104,96,34.358974358974365,201911
和光店,1300,1050,250,955,345,910,390,117,101,118,114,132,113,138,115,112,130,110,34.745714285714286,201911
品川店,1437,1166,271,1060,377,1001,436,139,119,137,129,149,130,126,124,128,124,132,34.313893653516296,201911
四街道店,820,666,154,578,242,576,244,67,66,78,80,69,67,81,77,82,86,67,34.46246246246246,201911
国分寺店,974,779,195,722,252,682,292,74,75,103,101,84,97,92,108,81,88,71,33.912708600770216,201911
国立店,1358,1092,266,1015,343,954,404,127,133,113,126,123,102,110,118,135,150,121,34.165750915750905,201911
坂戸店,1154,930,224,861,293,808,346,107,101,122,92,93,108,110,88,103,122,108,34.286021505376354,201911
墨田店,967,799,168,735,232,675,292,92,76,78,85,98,85,91,94,92,88,88,34.32040050062578,201911
多摩店,1063,854,209,807,256,744,319,95,88,103,92,84,97,96,101,118,97,92,34.30679156908665,201911
大久保店,1030,844,186,779,251,722,308,112,104,89,84,100,83,99,85,93,90,91,34.34241706161137,201911
大井店,1177,966,211,863,314,826,351,118,102,104,115,107,112,94,98,114,103,110,34.64182194616977,201911
大和店,1330,1061,269,972,358,931,399,134,99,128,117,108,109,126,145,114,127,123,34.651272384542885,201911
大塚店,1088,895,193,795,293,764,324,102,93,105,97,102,93,101,94,86,99,116,35.048044692737435,201911
大宮店,1322,1081,241,951,371,926,396,110,111,155,122,107,127,104,118,115,140,113,35.16558741905643,201911
大森店,1379,1137,242,995,384,966,413,110,130,109,138,129,130,130,133,125,129,116,34.684256816182945,201911
大泉店,1178,963,215,866,312,824,354,88,93,119,119,100,96,103,108,103,146,103,35.634475597092425,201911
大田店,914,744,170,667,247,641,273,84,84,87,80,86,89,80,89,81,72,82,33.952956989247305,201911
太田店,1319,1091,228,958,361,924,395,108,123,136,132,123,112,127,118,116,105,119,34.93217231897342,201911
宇都宮店,1057,861,196,790,267,741,316,82,108,95,114,104,87,110,92,93,85,87,34.69686411149826,201911
守谷店,1146,952,194,856,290,805,341,96,108,111,101,105,90,137,89,102,113,94,34.22058823529412,201911
宮前店,697,572,125,528,169,488,209,58,65,62,57,68,67,50,71,67,69,63,35.68356643356643,201911
富岡店,1055,849,206,785,270,738,317,90,77,114,89,97,108,85,88,107,103,97,34.515901060070675,201911
富津店,993,828,165,743,250,696,297,89,87,96,102,93,78,76,102,81,92,97,33.94323671497585,201911
富里店,1446,1182,264,1081,365,1015,431,132,128,121,141,127,147,136,136,132,130,116,34.29103214890017,201911
小山店,1000,839,161,752,248,699,301,73,99,87,77,98,99,100,89,98,107,73,35.55780691299166,201911
小平店,971,801,170,716,255,680,291,102,81,94,62,93,91,92,78,88,89,101,33.543071161048694,201911
小田原店,880,717,163,618,262,618,262,88,81,75,88,82,71,80,71,91,74,79,33.955369595536965,201911
小金井店,1064,878,186,784,280,747,317,89,99,107,104,110,92,97,87,98,102,79,35.592255125284744,201911
川口店,1090,887,203,796,294,764,326,83,95,113,114,98,104,84,101,92,100,106,35.26832018038331,201911
川崎多摩店,1084,874,210,808,276,756,328,98,90,91,99,125,105,87,94,99,102,94,34.34096109839817,201911
川崎店,1172,976,196,853,319,826,346,101,101,112,103,123,116,105,104,107,114,86,49.024590163934434,201911
川越店,1116,902,214,813,303,778,338,98,121,112,105,95,92,103,104,104,85,97,48.53991130820399,201911
巣鴨店,1455,1201,254,1091,364,1023,432,126,139,120,119,141,142,147,135,122,132,132,34.92756036636136,201911
市原店,1148,962,186,853,295,802,346,96,101,104,118,96,114,110,83,108,109,109,34.568607068607065,201911
市川店,1142,931,211,842,300,799,343,97,98,94,122,109,107,87,108,100,119,101,47.25563909774437,201911
平塚店,1151,932,219,845,306,805,346,123,89,103,117,107,90,93,125,100,99,105,34.50643776824034,201911
幸店,1371,1117,254,982,389,960,411,131,132,139,131,113,132,114,135,121,104,119,34.079677708146825,201911
府中店,1208,1009,199,914,294,845,363,108,122,102,102,106,118,121,89,120,123,97,34.24479682854311,201911
座間店,1324,1060,264,979,345,926,398,123,128,114,124,120,115,133,131,121,103,112,34.258490566037736,201911
志木店,887,730,157,652,235,620,267,78,83,83,71,93,80,93,79,72,94,61,34.652054794520545,201911
恵比寿店,998,800,198,740,258,698,300,82,93,96,80,93,103,83,104,79,101,84,20.43375,201911
愛甲店,1032,843,189,763,269,722,310,96,105,80,103,98,95,88,88,93,96,90,34.01067615658363,201911
成城店,1323,1072,251,1003,320,929,394,116,136,115,114,128,114,118,110,126,133,113,34.07089552238806,201911
成田店,851,682,169,623,228,599,252,84,86,72,71,76,79,85,71,85,69,73,34.37243401759531,201911
我孫子店,1087,912,175,795,292,761,326,105,92,88,102,104,106,97,99,109,101,84,20.61513157894737,201911
戸塚店,1499,1224,275,1118,381,1049,450,142,155,133,144,141,130,128,159,129,113,125,34.34640522875817,201911
戸田店,1494,1216,278,1127,367,1050,444,137,138,139,137,137,125,140,130,132,137,142,34.50904605263157,201911
所沢店,1142,913,229,823,319,799,343,114,100,97,108,106,94,90,116,112,114,91,34.59912376779847,201911
新宿店,1056,872,184,776,280,738,318,98,84,97,95,94,98,101,74,108,94,113,34.821100917431195,201911
新座店,997,805,192,741,256,698,299,84,101,84,99,93,86,79,84,93,93,101,35.03478260869565,201911
日本橋店,1412,1167,245,1039,373,993,419,130,119,119,141,136,120,131,125,127,137,127,34.772922022279346,201911
日立店,1269,1035,234,920,349,888,381,121,144,110,118,106,107,111,89,122,120,121,34.08405797101449,201911
日野店,1118,912,206,814,304,783,335,99,111,88,100,96,102,104,91,106,113,108,34.916666666666664,201911
旭店,1214,988,226,898,316,852,362,105,128,118,130,111,98,99,100,110,106,109,34.31983805668016,201911
春日部店,1141,939,202,845,296,797,344,105,104,102,95,98,118,108,117,81,109,104,34.911608093716715,201911
昭島店,1172,965,207,856,316,819,353,117,97,117,112,92,114,106,105,98,126,88,35.28497409326425,201911
木更津店,1081,869,212,796,285,755,326,103,125,93,108,109,90,107,74,95,89,88,35.00575373993095,201911
本庄店,1145,947,198,854,291,803,342,101,107,100,103,107,98,106,90,131,110,92,34.340021119324184,201911
本郷店,729,589,140,538,191,510,219,78,60,56,65,68,75,71,50,75,71,60,48.68421052631579,201911
杉並店,1196,987,209,880,316,836,360,95,101,96,119,138,101,115,90,114,113,114,35.52988855116514,201911
東中野店,1369,1118,251,1020,349,966,403,116,137,122,118,106,133,137,122,108,138,132,34.8685152057245,201911
東久留米店,858,705,153,626,232,598,260,78,85,68,82,80,81,66,82,80,63,93,35.44113475177305,201911
東大和店,1059,860,199,788,271,742,317,103,86,78,81,102,106,98,96,98,102,109,33.94883720930233,201911
東尾久店,1181,978,203,868,313,828,353,96,133,114,100,127,100,104,104,89,110,104,34.50204498977505,201911
東村山店,1035,819,216,784,251,727,308,110,75,89,99,92,81,90,101,89,107,102,35.46031746031746,201911
東松山店,1295,1071,224,936,359,908,387,112,109,115,118,108,127,114,124,106,132,130,34.803921568627445,201911
松戸店,1203,972,231,886,317,840,363,106,119,116,101,96,92,103,101,129,131,109,34.44855967078189,201911
板橋店,1056,877,179,787,269,744,312,92,109,101,94,110,88,80,88,82,102,110,48.671607753705814,201911
柏店,1464,1216,248,1063,401,1027,437,132,129,140,121,121,122,135,143,137,147,137,34.48108552631579,201911
栃木店,1062,862,200,796,266,742,320,108,92,94,82,108,86,95,96,119,94,88,34.024361948955914,201911
栄店,1527,1246,281,1143,384,1070,457,167,128,149,136,124,151,137,115,125,145,150,20.183788121990368,201911
桐生店,1195,969,226,882,313,842,353,122,108,103,102,109,104,112,120,110,95,110,33.836945304437556,201911
横浜南店,1388,1141,247,1011,377,974,414,122,114,134,125,108,136,130,119,129,144,127,34.63716038562664,201911
横浜緑店,1261,1036,225,917,344,881,380,93,102,110,83,118,117,116,125,131,128,138,34.71621621621622,201911
横須賀店,1061,852,209,804,257,742,319,119,97,101,100,94,106,87,91,88,90,88,34.51995305164319,201911
武蔵村山店,1259,1038,221,915,344,878,381,127,106,113,114,126,92,124,102,109,118,128,34.698458574181124,201911
武蔵野店,1051,858,193,792,259,736,315,94,78,85,105,107,99,91,93,109,96,94,34.3986013986014,201911
水戸店,1356,1117,239,1014,342,952,404,133,113,126,99,125,109,122,115,134,136,144,34.87197851387645,201911
江戸川店,1144,945,199,860,284,800,344,107,98,99,98,102,123,101,119,95,101,101,35.301587301587304,201911
江東店,1206,994,212,905,301,846,360,116,119,120,119,91,105,128,87,115,109,97,34.416498993963785,201911
池尻店,1171,974,197,877,294,817,354,118,112,102,119,113,107,105,85,104,107,99,35.690965092402465,201911
池袋店,1410,1162,248,1043,367,982,428,145,138,147,107,132,119,134,104,144,121,119,34.424268502581754,201911
泉店,1438,1179,259,1056,382,1008,430,130,136,130,125,132,141,107,141,126,133,137,33.87531806615776,201911
流山店,1468,1162,306,1063,405,1026,442,127,149,138,127,119,140,148,140,126,114,140,34.156626506024104,201911
浅草店,1361,1124,237,1006,355,950,411,107,134,118,139,138,128,105,129,129,125,109,34.627224199288264,201911
浦和店,1254,1005,249,911,343,879,375,117,109,121,121,125,120,100,103,105,109,124,34.319402985074625,201911
浦安店,1301,1057,244,970,331,911,390,130,128,126,126,119,126,115,85,102,116,128,34.33964049195837,201911
海老名店,1149,955,194,855,294,805,344,102,96,116,92,113,110,107,104,93,115,101,34.15706806282723,201911
清瀬店,1020,834,186,751,269,711,309,103,105,78,104,92,82,91,85,98,82,100,35.320143884892076,201911
渋谷店,1116,900,216,818,298,781,335,107,96,117,96,105,92,99,110,99,96,99,34.58888888888889,201911
港北店,1003,829,174,711,292,704,299,100,106,108,94,80,96,70,84,91,86,88,20.25090470446321,201911
港南店,1211,980,231,929,282,847,364,116,118,119,125,115,95,117,110,105,91,100,33.79489795918367,201911
瀬谷店,1412,1154,258,1079,333,988,424,110,134,131,136,115,143,139,116,143,118,127,34.0840554592721,201911
熊谷店,1083,860,223,826,257,759,324,115,81,85,95,108,98,89,93,105,118,96,35.12906976744186,201911
狛江店,1197,984,213,882,315,839,358,104,119,101,95,94,101,114,107,120,128,114,33.58231707317073,201911
狭山店,1384,1147,237,1003,381,974,410,114,132,123,130,117,120,133,128,148,118,121,34.38622493461203,201911
王子店,1116,898,218,814,302,780,336,95,94,83,99,124,105,96,97,99,104,120,19.93652561247216,201911
町田店,1290,1070,220,957,333,903,387,139,106,146,110,108,110,116,110,115,119,111,34.78411214953271,201911
白井店,1059,853,206,808,251,745,314,100,110,76,84,108,112,98,91,90,101,89,48.15005861664713,201911
目黒店,1174,961,213,847,327,824,350,117,106,96,99,98,107,100,116,107,108,120,34.22268470343393,201911
相模原店,1450,1207,243,1078,372,1016,434,161,116,120,118,138,134,119,133,128,152,131,34.46478873239437,201911
石神井店,943,779,164,723,220,660,283,84,102,72,106,65,78,97,86,90,89,74,47.721437740693204,201911
磯子店,909,756,153,662,247,635,274,79,79,72,69,88,87,111,83,74,78,89,34.3994708994709,201911
神奈川店,1360,1121,239,970,390,953,407,126,126,131,132,113,132,130,110,120,120,120,34.11775200713649,201911
神田店,1408,1113,295,1026,382,990,418,111,114,120,135,134,124,130,126,145,132,137,34.61096136567836,201911
福生店,1318,1088,230,984,334,922,396,121,114,124,111,119,124,131,103,129,120,122,33.866727941176464,201911
秦野店,1212,1009,203,907,305,848,364,96,122,112,94,107,115,136,105,98,117,110,33.988107036669966,201911
稲城店,949,769,180,696,253,662,287,83,99,87,84,91,68,92,100,81,87,77,47.62418725617685,201911
立川店,1271,1045,226,950,321,888,383,101,96,106,117,120,113,116,125,127,133,117,34.427751196172245,201911
綾瀬店,2624,2152,472,1973,651,1834,790,249,237,242,260,242,235,229,229,227,255,219,34.49628252788104,201911
練馬店,1383,1149,234,1018,365,966,417,126,127,129,119,112,126,135,119,144,126,120,34.1201044386423,201911
羽村店,1355,1100,255,996,359,951,404,120,116,132,121,120,117,117,128,120,129,135,20.48,201911
羽生店,1302,1058,244,970,332,912,390,123,102,105,136,110,119,116,133,118,116,124,33.8875236294896,201911
習志野店,1375,1115,260,1005,370,965,410,124,121,154,133,117,98,112,139,129,120,128,34.39103139013453,201911
自由が丘店,1268,1060,208,931,337,888,380,127,101,119,122,108,108,115,105,130,112,121,33.883962264150945,201911
船橋店,1438,1175,263,1092,346,1007,431,135,120,123,132,120,147,124,136,131,139,131,34.61191489361702,201911
若葉店,1149,933,216,881,268,802,347,115,104,119,105,121,86,101,99,114,93,92,34.79849946409432,201911
茂原店,1325,1100,225,979,346,928,397,125,105,110,114,138,123,118,135,130,98,129,34.26636363636364,201911
茅ヶ崎店,882,734,148,667,215,615,267,83,73,97,88,84,71,102,61,76,70,77,34.298365122615806,201911
草加店,968,774,194,713,255,676,292,86,89,82,83,90,85,90,98,90,80,95,34.89664082687339,201911
荒川店,886,724,162,646,240,623,263,78,100,81,73,67,85,72,79,89,82,80,35.36878453038674,201911
荻窪店,1209,1017,192,917,292,849,360,111,105,123,120,109,105,109,109,103,103,112,20.60275319567355,201911
葛飾店,1118,919,199,825,293,783,335,104,101,101,94,108,85,97,114,120,108,86,34.181719260065286,201911
蒲田店,990,784,206,745,245,693,297,86,89,88,88,92,96,102,99,74,88,88,34.51275510204081,201911
藤沢店,1148,957,191,836,312,803,345,92,95,110,95,109,101,102,100,120,110,114,34.751306165099265,201911
行田店,962,777,185,732,230,675,287,93,83,90,78,94,67,79,106,88,91,93,34.665379665379675,201911
西多摩店,1537,1260,277,1156,381,1075,462,144,151,143,151,138,116,152,149,108,146,139,34.673809523809524,201911
西東京店,967,773,194,713,254,678,289,83,87,75,94,91,99,94,85,92,96,71,34.32729624838292,201911
西葛西店,798,650,148,610,188,559,239,70,65,71,82,60,76,64,83,69,82,76,34.793846153846154,201911
調布店,1379,1115,264,1018,361,964,415,128,115,120,130,118,131,123,130,131,108,145,34.63766816143498,201911
谷中店,1504,1222,282,1136,368,1052,452,122,135,144,121,151,135,148,134,138,139,137,34.167757774140746,201911
赤坂店,1000,820,180,725,275,699,301,89,94,89,93,100,85,89,90,83,90,98,34.5170731707317,201911
赤羽店,1141,925,216,835,306,798,343,99,100,107,87,118,104,110,109,98,110,99,46.84648648648648,201911
越谷店,873,717,156,638,235,614,259,69,81,88,89,89,79,78,60,66,80,94,48.63598326359833,201911
足利店,783,638,145,600,183,546,237,60,63,79,69,73,80,65,75,82,81,56,34.52664576802508,201911
足柄上店,1199,983,216,873,326,838,361,99,112,113,123,95,124,96,117,105,98,117,33.81790437436419,201911
足立店,847,677,170,651,196,592,255,85,77,71,81,83,87,63,77,85,67,71,34.159527326440184,201911
逗子店,1050,850,200,778,272,735,315,90,107,90,87,96,100,93,95,96,87,109,34.103529411764704,201911
那珂店,1169,971,198,839,330,817,352,109,99,94,122,105,89,104,113,123,103,108,20.06076210092688,201911
都筑店,1002,822,180,755,247,699,303,89,110,85,107,80,84,79,86,94,95,93,33.96593673965937,201911
金沢店,1232,973,259,914,318,859,373,123,97,109,117,115,108,144,86,105,119,109,20.05035971223021,201911
銀座店,973,810,163,720,253,684,289,73,87,111,87,81,93,92,76,98,103,72,34.50740740740741,201911
鎌倉店,968,814,154,721,247,676,292,90,92,93,94,92,70,78,88,85,84,102,34.46068796068796,201911
青山店,1327,1099,228,1009,318,927,400,120,128,120,136,117,113,97,134,119,119,124,35.1901728844404,201911
青梅店,1245,1029,216,933,312,869,376,108,108,116,125,111,97,117,93,118,113,139,34.456754130223516,201911
青葉店,1125,906,219,827,298,789,336,85,103,109,112,89,105,95,101,102,106,118,34.40286975717439,201911
館林店,1145,933,212,830,315,802,343,88,128,116,96,107,109,101,116,103,84,97,35.035369774919616,201911
駒沢店,1005,810,195,728,277,701,304,77,74,82,102,100,99,108,76,97,100,90,34.3716049382716,201911
駒込店,1437,1169,268,1043,394,1006,431,140,127,114,140,146,126,113,118,127,144,142,34.75876817792985,201911
高円寺店,1383,1147,236,1011,372,969,414,121,122,143,141,123,130,133,106,146,108,110,33.791630340017434,201911
高島平店,1203,980,223,889,314,839,364,107,103,130,102,100,110,97,116,112,110,116,34.830612244897964,201911
高崎店,1116,893,223,798,318,779,337,102,102,107,103,94,95,108,92,103,111,99,34.751399776035825,201911
高座店,1120,925,195,840,280,783,337,102,103,100,105,107,105,103,110,96,94,95,34.22162162162162,201911
高津店,1123,926,197,821,302,789,334,80,94,131,89,97,110,112,101,87,111,111,34.553995680345565,201911
高田馬場店,1060,870,190,815,245,741,319,104,108,100,79,102,96,95,89,99,108,80,35.00114942528736,201911
鴻巣店,1108,907,201,835,273,772,336,82,105,115,96,99,104,95,93,102,114,103,34.89195148842337,201911
鶴見店,1476,1212,264,1106,370,1033,443,147,134,126,153,133,125,139,139,137,118,125,34.14108910891089,201911
麻生店,1358,1106,252,1021,337,952,406,138,107,136,106,119,130,129,124,135,120,114,34.403254972875224,201911
あきる野店,1189,975,214,881,308,844,345,119,120,102,108,103,105,89,102,114,106,121,34.73948717948718,201912
さいたま南店,1545,1248,297,1140,405,1095,450,147,146,156,112,138,129,137,136,163,140,141,33.98157051282051,201912
さいたま緑店,1070,878,192,788,282,757,313,98,104,106,76,99,113,95,84,97,102,96,33.940774487471536,201912
さいたま西店,1215,986,229,917,298,865,350,112,117,99,115,114,115,114,114,88,120,107,33.74442190669371,201912
つくば店,1295,1041,254,966,329,917,378,117,106,120,125,127,112,117,119,112,112,128,34.99903938520653,201912
三浦店,1190,989,201,850,340,849,341,113,112,124,121,122,110,107,98,97,89,97,34.40242669362993,201912
三鷹店,1546,1244,302,1170,376,1099,447,150,142,142,119,151,135,132,157,129,146,143,34.053054662379424,201912
上尾店,1365,1131,234,1016,349,968,397,122,133,117,118,128,124,125,131,120,126,121,20.633068081343946,201912
上野店,1672,1362,310,1240,432,1188,484,155,147,155,143,166,157,164,157,132,149,147,34.89720998531571,201912
世田谷店,1581,1300,281,1175,406,1123,458,141,121,145,129,142,141,147,133,161,164,157,34.512307692307694,201912
中原店,1577,1274,303,1195,382,1123,454,177,139,116,150,145,143,155,164,146,134,108,34.36577708006279,201912
中店,1244,1019,225,925,319,883,361,109,111,102,109,113,113,99,143,119,113,113,34.00098135426889,201912
中野店,1194,971,223,874,320,849,345,102,110,118,96,113,106,115,104,102,111,117,34.80947476828013,201912
久喜店,1343,1094,249,1027,316,954,389,115,139,128,110,136,109,117,115,137,125,112,34.91590493601463,201912
九段店,1365,1121,244,1029,336,966,399,123,117,99,147,126,132,134,134,126,120,107,35.07671721677074,201912
亀有店,1065,862,203,767,298,756,309,106,84,104,106,80,74,98,97,106,101,109,34.56380510440835,201912
五反田店,1187,968,219,868,319,843,344,126,110,97,95,104,116,99,114,134,89,103,33.89462809917355,201912
代々木店,1400,1167,233,1005,395,992,408,134,119,140,134,145,136,116,114,144,128,90,34.40959725792631,201912
伊勢原店,1485,1218,267,1089,396,1051,434,129,135,132,141,132,136,122,139,127,165,127,34.71756978653531,201912
伊勢崎店,1639,1323,316,1215,424,1168,471,157,152,161,142,126,147,158,135,150,150,161,34.52305366591081,201912
佐倉店,908,751,157,689,219,643,265,90,98,80,81,75,84,81,78,82,73,86,34.138482023968045,201912
佐野店,1535,1270,265,1117,418,1087,448,133,129,134,145,127,153,148,133,147,147,139,33.82362204724409,201912
保土ケ谷店,1314,1087,227,968,346,933,381,120,120,127,117,115,127,114,117,122,123,112,34.008279668813245,201912
入間店,1175,964,211,889,286,839,336,106,106,119,104,103,112,106,107,82,112,118,34.23236514522821,201912
八千代店,1276,1052,224,949,327,902,374,110,110,125,121,118,108,125,123,108,108,120,34.472433460076054,201912
八潮店,1246,1054,192,918,328,886,360,113,117,108,109,120,112,123,128,94,104,118,34.378557874762805,201912
八王子店,1579,1288,291,1133,446,1116,463,130,125,159,146,149,141,140,166,141,144,138,35.0527950310559,201912
六本木店,1031,859,172,760,271,736,295,103,84,100,104,94,89,79,84,98,111,85,33.988358556461,201912
前橋店,849,709,140,646,203,602,247,55,87,82,74,76,77,82,78,77,77,84,34.63751763046545,201912
北千住店,1036,840,196,752,284,734,302,77,84,100,93,120,84,98,88,98,92,102,35.30357142857143,201912
千葉中央店,1306,1048,258,961,345,925,381,119,123,111,121,128,118,121,145,103,120,97,34.20610687022901,201912
千葉緑店,1187,966,221,852,335,845,342,134,113,106,86,98,103,105,100,119,123,100,34.475155279503106,201912
南砂店,1300,1075,225,937,363,926,374,162,114,115,113,128,103,116,103,121,118,107,34.01023255813953,201912
南足柄店,1032,840,192,782,250,733,299,95,102,84,97,88,102,86,122,77,95,84,35.11190476190476,201912
厚木店,1484,1212,272,1109,375,1054,430,136,129,133,132,133,129,140,134,137,146,135,34.448019801980195,201912
取手店,1185,962,223,886,299,842,343,102,109,91,125,109,102,111,109,108,116,103,34.82224532224532,201912
向島店,1066,891,175,790,276,754,312,89,102,103,91,97,102,80,110,82,106,104,33.94051627384961,201912
君津店,1121,904,217,830,291,795,326,103,123,105,93,107,96,107,108,105,83,91,34.74336283185841,201912
和光店,1345,1083,262,999,346,954,391,119,130,120,140,123,109,126,125,118,120,115,34.69990766389658,201912
品川店,1491,1225,266,1120,371,1057,434,127,133,122,169,141,138,129,136,139,121,136,35.34448979591837,201912
四街道店,853,699,154,630,223,603,250,99,91,78,65,71,75,65,86,70,75,78,34.60085836909871,201912
国分寺店,999,808,191,732,267,709,290,87,100,96,91,112,84,80,103,81,85,80,34.679455445544555,201912
国立店,1397,1125,272,1014,383,994,403,119,123,129,152,132,114,126,122,122,131,127,34.26844444444444,201912
坂戸店,1193,990,203,882,311,848,345,101,90,112,122,115,100,105,105,114,114,115,34.29797979797981,201912
墨田店,997,829,168,743,254,703,294,81,85,94,91,102,95,78,80,85,100,106,34.085645355850424,201912
多摩店,1090,894,196,812,278,769,321,95,110,102,94,103,98,89,94,108,101,96,33.977628635346754,201912
大久保店,1064,850,214,802,262,756,308,101,100,111,89,94,89,87,100,83,97,113,34.249411764705876,201912
大井店,1216,1010,206,911,305,862,354,109,99,96,118,108,119,101,114,115,109,128,34.13861386138614,201912
大和店,1359,1103,256,1003,356,964,395,135,141,127,117,112,117,127,134,121,120,108,33.81142339075249,201912
大塚店,1121,896,225,820,301,795,326,99,94,116,129,97,94,86,116,97,87,106,34.793526785714285,201912
大宮店,1365,1125,240,1009,356,970,395,119,128,119,124,127,131,130,117,125,123,122,34.318222222222225,201912
大森店,1426,1182,244,1074,352,1010,416,120,146,147,132,139,104,144,106,112,140,136,34.22165820642978,201912
大泉店,1211,983,228,900,311,861,350,101,86,105,102,121,141,100,115,116,110,114,34.271617497456766,201912
大田店,943,757,186,708,235,670,273,92,86,82,81,79,85,82,96,87,97,76,33.96565389696169,201912
太田店,1353,1106,247,1006,347,963,390,118,130,125,116,131,116,112,140,128,120,117,34.84177215189873,201912
宇都宮店,1095,899,196,848,247,776,319,102,109,92,101,116,107,101,82,97,88,100,35.067853170189096,201912
守谷店,1183,957,226,854,329,839,344,102,108,92,114,109,94,116,114,111,115,108,34.048066875653085,201912
宮前店,732,615,117,550,182,520,212,61,85,62,71,64,59,79,73,59,52,67,34.74471544715447,201912
富岡店,1097,881,216,819,278,778,319,123,107,90,98,103,92,79,104,106,98,97,33.78206583427923,201912
富津店,1036,851,185,781,255,733,303,94,99,95,91,94,88,96,110,91,90,88,34.34900117508813,201912
富里店,1484,1248,236,1107,377,1051,433,127,142,132,162,134,126,139,134,134,130,124,33.94310897435897,201912
小山店,1043,858,185,768,275,742,301,113,110,94,89,101,75,111,78,88,99,85,35.36130536130536,201912
小平店,1002,800,202,750,252,715,287,97,99,85,100,93,89,77,78,97,94,93,34.01125,201912
小田原店,909,761,148,693,216,646,263,83,91,88,89,94,100,57,81,77,78,71,34.67411300919842,201912
小金井店,1098,896,202,815,283,779,319,102,92,108,88,98,108,104,88,94,111,105,34.140625,201912
川口店,1123,939,184,830,293,794,329,104,106,96,95,97,105,86,105,126,112,91,34.73695420660277,201912
川崎多摩店,1123,905,218,837,286,795,328,101,98,99,94,104,98,111,101,99,102,116,34.45635359116022,201912
川崎店,1209,994,215,879,330,858,351,96,113,92,112,95,126,114,110,123,102,126,46.39134808853119,201912
川越店,1157,939,218,840,317,820,337,107,96,88,91,118,121,124,98,109,102,103,47.84558040468583,201912
巣鴨店,1509,1243,266,1123,386,1068,441,143,153,128,143,135,128,153,128,129,122,147,34.67900241351569,201912
市原店,1179,954,225,851,328,834,345,117,93,113,125,123,97,101,100,98,104,108,34.90880503144654,201912
市川店,1181,956,225,880,301,839,342,112,97,110,101,121,99,117,114,97,120,93,47.814853556485346,201912
平塚店,1183,983,200,869,314,844,339,113,102,110,94,97,114,108,112,109,121,103,35.038657171922694,201912
幸店,1433,1163,270,1069,364,1017,416,126,124,138,125,145,121,121,116,127,147,143,34.48409286328461,201912
府中店,1243,1023,220,924,319,880,363,123,113,107,123,102,108,119,112,102,109,125,34.50244379276637,201912
座間店,1368,1126,242,992,376,968,400,131,125,115,111,116,119,127,124,135,128,137,33.769094138543515,201912
志木店,916,725,191,697,219,649,267,90,80,76,80,83,87,82,75,82,80,101,34.96689655172414,201912
恵比寿店,1039,827,212,783,256,740,299,104,105,88,84,106,97,91,87,85,97,95,20.259975816203145,201912
愛甲店,1075,883,192,797,278,763,312,105,85,87,80,108,91,114,95,91,104,115,34.72933182332956,201912
成城店,1370,1141,229,1015,355,970,400,124,123,108,126,123,132,121,140,114,137,122,34.21121822962313,201912
成田店,886,721,165,657,229,628,258,77,84,77,80,73,89,72,98,83,75,78,34.14147018030513,201912
我孫子店,1132,919,213,843,289,805,327,105,96,91,119,97,100,101,102,112,98,111,20.458106637649614,201912
戸塚店,1553,1280,273,1160,393,1099,454,135,123,145,159,144,157,111,139,138,141,161,34.33671875,201912
戸田店,1550,1276,274,1160,390,1101,449,133,143,143,137,142,123,153,154,136,146,140,34.20689655172413,201912
所沢店,1186,954,232,857,329,839,347,128,109,100,105,122,94,106,117,98,97,110,34.61320754716981,201912
新宿店,1088,868,220,798,290,773,315,109,98,102,95,92,105,83,84,103,99,118,34.514976958525345,201912
新座店,1028,842,186,794,234,733,295,93,88,100,90,109,94,98,94,94,75,93,33.86817102137767,201912
日本橋店,1459,1216,243,1077,382,1036,423,152,142,108,123,123,141,130,155,113,136,136,34.47779605263157,201912
日立店,1314,1074,240,939,375,930,384,122,121,129,118,113,133,100,116,128,100,134,34.798882681564244,201912
日野店,1155,941,214,835,320,820,335,90,109,105,103,114,101,127,101,100,118,87,34.7066950053135,201912
旭店,1250,1043,207,934,316,885,365,103,113,101,104,131,131,99,125,114,125,104,33.990412272291465,201912
春日部店,1178,965,213,917,261,839,339,111,116,116,104,92,118,104,102,123,82,110,34.647668393782375,201912
昭島店,1206,972,234,883,323,854,352,104,116,112,121,104,101,106,112,129,102,99,33.80761316872428,201912
木更津店,1127,922,205,831,296,800,327,101,102,125,85,90,113,116,91,96,104,104,34.50650759219089,201912
本庄店,1179,958,221,891,288,837,342,130,119,95,110,106,94,105,90,96,102,132,34.97494780793319,201912
本郷店,755,596,159,564,191,538,217,70,69,57,63,71,71,76,71,79,63,65,48.01677852348993,201912
杉並店,1244,989,255,943,301,885,359,107,117,118,116,92,125,125,105,116,107,116,34.51061678463094,201912
東中野店,1427,1183,244,1079,348,1010,417,139,139,138,148,122,125,129,115,117,133,122,35.041420118343204,201912
東久留米店,880,705,175,647,233,624,256,74,78,83,66,85,69,92,78,77,87,91,34.21985815602837,201912
東大和店,1092,869,223,820,272,774,318,112,88,89,101,96,90,92,97,119,120,88,34.31645569620253,201912
東尾久店,1216,994,222,887,329,868,348,116,102,110,102,132,123,104,94,115,109,109,33.85613682092556,201912
東村山店,1065,873,192,795,270,755,310,102,97,97,95,101,84,110,92,99,96,92,34.91523482245132,201912
東松山店,1323,1080,243,990,333,940,383,116,130,113,108,110,133,137,107,128,114,127,33.97962962962963,201912
松戸店,1249,1001,248,938,311,886,363,120,108,118,114,122,98,112,124,100,117,116,34.91908091908092,201912
板橋店,1092,882,210,818,274,772,320,100,112,81,100,105,97,102,108,90,109,88,48.434240362811785,201912
柏店,1529,1263,266,1121,408,1088,441,120,152,137,123,151,144,130,127,150,140,155,34.266033254156774,201912
栃木店,1098,894,204,836,262,780,318,94,102,101,88,108,86,93,107,101,113,105,34.36912751677853,201912
栄店,1575,1275,300,1145,430,1118,457,136,159,138,156,163,140,146,141,127,138,131,19.85176470588236,201912
桐生店,1250,991,259,933,317,884,366,103,123,115,119,115,110,110,109,116,113,117,34.013118062563066,201912
横浜南店,1429,1176,253,1055,374,1018,411,144,152,153,117,142,118,122,133,128,126,94,34.627551020408156,201912
横浜緑店,1309,1058,251,993,316,927,382,123,110,137,121,119,119,120,97,134,107,122,34.77126654064272,201912
横須賀店,1089,905,184,797,292,773,316,90,94,108,90,107,98,112,104,92,96,98,33.98342541436464,201912
武蔵村山店,1312,1074,238,993,319,929,383,139,109,143,118,98,102,118,143,98,117,127,34.71880819366853,201912
武蔵野店,1097,908,189,816,281,781,316,114,121,89,107,90,87,91,96,103,87,112,34.18171806167401,201912
水戸店,1389,1144,245,1017,372,984,405,120,132,148,118,141,108,123,134,115,130,120,33.82604895104895,201912
江戸川店,1183,958,225,858,325,840,343,96,100,109,106,124,102,91,111,117,128,99,34.47599164926931,201912
江東店,1250,1013,237,897,353,886,364,126,127,123,116,119,104,109,106,104,109,107,34.59624876604146,201912
池尻店,1219,992,227,905,314,868,351,130,113,119,122,107,97,107,106,99,121,98,33.89616935483871,201912
池袋店,1463,1184,279,1096,367,1040,423,131,125,131,137,132,141,145,125,130,140,126,34.210304054054056,201912
泉店,1484,1214,270,1118,366,1053,431,156,126,127,127,130,126,133,142,145,148,124,34.038714991762774,201912
流山店,1518,1242,276,1139,379,1076,442,139,129,155,117,127,145,155,152,125,139,135,34.15619967793881,201912
浅草店,1397,1146,251,1028,369,993,404,125,139,132,128,114,119,154,122,108,133,123,34.713787085514824,201912
浦和店,1311,1065,246,984,327,930,381,130,144,128,87,110,135,119,107,115,110,126,34.89201877934272,201912
浦安店,1331,1058,273,982,349,942,389,127,137,120,117,119,110,120,125,104,126,126,34.58695652173913,201912
海老名店,1185,981,204,869,316,843,342,106,128,110,104,101,106,117,101,106,93,113,34.41997961264016,201912
清瀬店,1064,874,190,798,266,754,310,87,83,102,105,82,116,97,104,76,100,112,34.276887871853546,201912
渋谷店,1156,928,228,868,288,821,335,88,110,111,112,110,106,112,95,121,92,99,35.11206896551724,201912
港北店,1028,835,193,731,297,730,298,95,105,93,93,83,94,82,97,103,90,93,20.324550898203594,201912
港南店,1246,1026,220,897,349,886,360,122,95,125,122,123,109,108,118,99,107,118,34.217348927875236,201912
瀬谷店,1458,1193,265,1045,413,1034,424,130,147,147,153,147,133,119,113,119,140,110,34.60016764459346,201912
熊谷店,1127,912,215,812,315,801,326,100,91,93,92,104,95,107,116,110,113,106,35.05701754385965,201912
狛江店,1251,1008,243,921,330,887,364,110,119,135,119,99,130,118,107,115,109,90,34.753968253968246,201912
狭山店,1424,1161,263,1076,348,1012,412,136,111,119,127,138,122,126,153,138,123,131,34.47975882859604,201912
王子店,1153,925,228,891,262,820,333,99,107,125,98,106,97,124,87,108,105,97,20.438918918918922,201912
町田店,1343,1102,241,974,369,952,391,147,120,112,110,124,133,130,131,116,111,109,35.08711433756806,201912
白井店,1092,892,200,825,267,775,317,99,91,108,95,97,103,103,107,87,108,94,48.181614349775785,201912
目黒店,1217,967,250,866,351,864,353,105,113,108,130,101,87,107,123,115,107,121,34.24198552223371,201912
相模原店,1491,1205,286,1095,396,1055,436,144,134,146,138,123,118,130,150,139,136,133,34.076348547717835,201912
石神井店,973,788,185,725,248,696,277,80,97,76,96,96,89,92,92,96,99,60,48.90736040609136,201912
磯子店,948,792,156,711,237,671,277,78,87,76,77,82,88,92,111,85,83,89,35.04924242424242,201912
神奈川店,1392,1144,248,1022,370,989,403,151,129,106,127,122,110,114,137,128,133,135,34.84003496503497,201912
神田店,1459,1213,246,1064,395,1035,424,144,133,132,132,139,123,123,133,141,131,128,34.08491343775763,201912
福生店,1356,1084,272,983,373,963,393,115,114,94,130,139,131,147,142,118,113,113,34.065498154981555,201912
秦野店,1248,1005,243,919,329,888,360,111,110,114,108,95,124,116,128,97,133,112,34.54129353233831,201912
稲城店,974,806,168,698,276,690,284,86,90,80,79,80,112,95,84,93,79,96,48.99751861042185,201912
立川店,1308,1073,235,956,352,928,380,106,106,131,117,134,129,122,116,116,106,125,34.60857409133271,201912
綾瀬店,2711,2199,512,2065,646,1923,788,257,240,258,228,258,232,277,261,237,232,231,34.803547066848566,201912
練馬店,1421,1147,274,1047,374,1006,415,127,127,121,134,143,130,139,143,123,112,122,34.53443766346992,201912
羽村店,1398,1140,258,1052,346,989,409,116,139,134,142,140,129,114,129,135,116,104,19.902631578947368,201912
羽生店,1340,1105,235,996,344,951,389,113,140,113,103,132,120,122,126,119,127,125,34.34027149321267,201912
習志野店,1434,1174,260,1048,386,1017,417,133,145,136,118,132,111,118,147,133,127,134,34.85434412265758,201912
自由が丘店,1306,1070,236,982,324,925,381,132,100,107,129,118,114,113,120,124,126,123,33.97102803738318,201912
船橋店,1495,1230,265,1098,397,1063,432,133,152,134,136,127,147,141,144,117,141,123,34.6609756097561,201912
若葉店,1178,973,205,875,303,838,340,112,123,100,106,88,108,100,108,103,104,126,34.810894141829394,201912
茂原店,1367,1114,253,994,373,968,399,128,113,129,140,122,137,125,108,114,126,125,34.171454219030515,201912
茅ヶ崎店,906,734,172,679,227,643,263,90,76,79,90,75,89,79,68,83,91,86,35.020435967302454,201912
草加店,998,809,189,744,254,708,290,114,77,93,92,98,116,78,72,86,84,88,34.65265760197775,201912
荒川店,922,740,182,684,238,654,268,81,79,76,81,87,84,80,88,89,87,90,34.03513513513513,201912
荻窪店,1249,1015,234,927,322,890,359,100,110,120,105,122,127,101,129,112,118,105,19.99113300492611,201912
葛飾店,1155,934,221,846,309,817,338,114,110,124,94,91,105,100,87,87,124,119,35.049250535331915,201912
蒲田店,1033,857,176,789,244,731,302,85,102,96,96,96,96,100,112,73,95,82,34.88331388564761,201912
藤沢店,1186,981,205,876,310,842,344,107,103,89,101,117,104,113,117,95,101,139,33.87767584097859,201912
行田店,1003,815,188,726,277,717,286,84,89,89,92,118,85,83,121,79,88,75,34.58036809815951,201912
西多摩店,1565,1264,301,1153,412,1110,455,153,140,146,140,134,167,139,138,126,139,143,34.43037974683544,201912
西東京店,1006,816,190,745,261,716,290,95,89,104,87,83,80,102,98,100,80,88,35.35906862745097,201912
西葛西店,819,655,164,614,205,580,239,78,59,73,77,78,66,81,71,74,81,81,33.87328244274809,201912
調布店,1422,1169,253,1046,376,1009,413,135,106,127,125,139,142,118,114,136,150,130,35.21471343028229,201912
谷中店,1554,1292,262,1161,393,1104,450,148,128,128,141,143,148,153,128,158,151,128,34.68343653250774,201912
赤坂店,1032,841,191,758,274,730,302,89,113,85,91,90,100,92,104,93,81,94,34.27110582639715,201912
赤羽店,1184,975,209,863,321,837,347,125,96,122,106,98,109,118,93,97,114,106,47.894358974358965,201912
越谷店,911,738,173,694,217,644,267,69,79,80,99,82,75,86,81,72,103,85,48.05962059620596,201912
足利店,820,676,144,606,214,584,236,67,71,80,80,73,71,85,76,77,76,64,33.45266272189349,201912
足柄上店,1251,1016,235,920,331,891,360,125,96,114,119,145,112,114,103,114,103,106,34.67125984251968,201912
足立店,878,706,172,651,227,620,258,67,84,90,79,64,87,83,87,73,97,67,34.22662889518413,201912
逗子店,1091,917,174,815,276,773,318,105,117,90,85,88,98,95,101,102,111,99,33.70338058887677,201912
那珂店,1223,988,235,908,315,869,354,105,115,102,94,106,121,108,112,132,112,116,20.339068825910925,201912
都筑店,1035,834,201,775,260,735,300,101,93,102,94,77,90,89,89,98,100,102,34.164268585131886,201912
金沢店,1272,1031,241,921,351,904,368,123,100,111,111,130,124,100,129,103,115,126,19.9815712900097,201912
銀座店,1004,824,180,750,254,714,290,99,102,82,91,94,83,91,82,88,90,102,34.110436893203875,201912
鎌倉店,1000,834,166,732,268,710,290,91,87,97,72,101,92,97,85,89,94,95,34.47242206235012,201912
青山店,1365,1123,242,1035,330,970,395,129,111,114,132,123,124,139,121,132,115,125,34.417631344612644,201912
青梅店,1283,1060,223,978,305,909,374,125,107,116,123,122,98,105,129,120,115,123,34.906603773584905,201912
青葉店,1160,955,205,835,325,826,334,96,102,95,144,103,114,101,101,108,99,97,34.742408376963354,201912
館林店,1181,931,250,857,324,834,347,101,115,104,119,108,96,93,118,111,112,104,35.07089151450054,201912
駒沢店,1036,864,172,779,257,736,300,91,103,103,87,88,107,79,95,86,98,99,34.675925925925924,201912
駒込店,1492,1226,266,1111,381,1058,434,136,133,145,145,112,127,165,158,101,153,117,34.026916802610124,201912
高円寺店,1425,1135,290,1059,366,1013,412,128,124,112,126,114,138,113,147,147,140,136,34.615859030837,201912
高島平店,1253,1018,235,925,328,888,365,116,118,113,124,108,101,131,107,116,106,113,34.3713163064833,201912
高崎店,1159,940,219,855,304,823,336,113,107,113,103,112,101,96,89,95,109,121,34.13936170212766,201912
高座店,1146,919,227,858,288,811,335,120,90,95,114,108,109,100,96,110,100,104,34.890097932535355,201912
高津店,1158,930,228,837,321,820,338,106,119,107,91,96,107,94,109,105,106,118,35.07741935483871,201912
高田馬場店,1093,884,209,781,312,776,317,99,107,99,105,98,104,89,106,89,92,105,34.73190045248869,201912
鴻巣店,1151,919,232,844,307,814,337,97,115,119,95,108,122,114,90,99,103,89,34.60500544069641,201912
鶴見店,1515,1244,271,1157,358,1074,441,133,139,136,122,136,171,149,126,137,130,136,34.17282958199357,201912
麻生店,1394,1129,265,1031,363,985,409,124,114,139,127,121,129,131,110,132,137,130,34.06200177147919,201912
あきる野店,1186,978,208,884,302,881,305,97,126,115,108,99,111,109,99,112,110,100,34.45296523517382,202001
さいたま南店,1550,1263,287,1166,384,1151,399,138,141,144,147,146,141,129,121,148,139,156,34.200316706254945,202001
さいたま緑店,1056,878,178,779,277,780,276,93,93,110,98,106,88,92,93,96,100,87,34.97722095671982,202001
さいたま西店,1209,975,234,885,324,897,312,123,101,114,116,109,115,108,113,97,113,100,34.47897435897436,202001
つくば店,1308,1063,245,997,311,973,335,123,120,105,109,127,124,115,113,104,137,131,34.636876763875826,202001
三浦店,1192,991,201,903,289,884,308,115,104,90,114,112,133,105,103,107,108,101,34.686175580222,202001
三鷹店,1551,1257,294,1145,406,1149,402,148,114,138,148,156,142,151,141,128,151,134,34.56801909307876,202001
上尾店,1367,1132,235,994,373,1014,353,130,131,123,107,127,121,118,130,121,123,136,20.083038869257948,202001
上野店,1664,1327,337,1235,429,1239,425,143,155,156,134,142,166,143,155,170,166,134,35.031650339110776,202001
世田谷店,1588,1278,310,1167,421,1177,411,156,144,146,132,151,154,126,120,162,140,157,34.509389671361504,202001
中原店,1580,1299,281,1192,388,1174,406,146,135,144,142,147,145,141,138,154,157,131,34.46728252501924,202001
中店,1247,1024,223,951,296,921,326,86,148,90,121,119,109,145,111,111,89,118,34.9541015625,202001
中野店,1180,953,227,860,320,878,302,105,109,103,125,102,103,107,108,108,108,102,35.572927597061906,202001
久喜店,1346,1079,267,971,375,1000,346,114,115,140,124,131,115,116,113,137,121,120,34.247451343836886,202001
九段店,1370,1117,253,1025,345,1016,354,130,115,114,137,125,101,138,129,130,135,116,34.30617726051925,202001
亀有店,1070,882,188,805,265,795,275,89,102,104,100,100,122,78,77,109,96,93,35.49773242630385,202001
五反田店,1184,969,215,878,306,878,306,104,106,126,95,121,107,96,107,91,114,117,34.25593395252837,202001
代々木店,1396,1112,284,1023,373,1033,363,131,121,132,126,135,128,141,129,114,119,120,34.789568345323744,202001
伊勢原店,1491,1212,279,1094,397,1104,387,148,143,130,129,136,121,135,121,132,157,139,34.50247524752475,202001
伊勢崎店,1635,1333,302,1218,417,1214,421,146,145,155,147,155,139,146,144,161,143,154,34.958739684921234,202001
佐倉店,907,745,162,671,236,672,235,87,76,76,95,103,75,89,70,80,76,80,34.53422818791946,202001
佐野店,1540,1263,277,1128,412,1143,397,144,134,144,145,144,129,139,140,139,144,138,34.6492478226445,202001
保土ケ谷店,1297,1078,219,978,319,966,331,124,119,103,125,104,131,132,101,113,119,126,35.21335807050093,202001
入間店,1182,966,216,900,282,874,308,109,114,96,100,122,114,112,115,101,96,103,33.113871635610764,202001
八千代店,1273,1048,225,923,350,945,328,122,123,115,111,94,127,115,127,125,99,115,34.66412213740458,202001
八潮店,1254,1015,239,905,349,928,326,124,131,100,112,111,99,121,106,119,116,115,34.77044334975369,202001
八王子店,1575,1277,298,1129,446,1172,403,145,156,144,130,142,143,144,150,141,130,150,34.47454972592013,202001
六本木店,1032,822,210,769,263,765,267,92,94,103,94,91,87,95,93,102,91,90,34.77493917274939,202001
前橋店,847,698,149,614,233,625,222,59,88,61,72,88,75,92,77,74,78,83,33.969914040114624,202001
北千住店,1027,847,180,751,276,761,266,90,86,90,100,97,94,87,110,98,78,97,33.90318772136954,202001
千葉中央店,1310,1063,247,978,332,971,339,112,121,125,111,112,102,136,121,112,123,135,34.462841015992474,202001
千葉緑店,1186,958,228,877,309,880,306,123,96,95,85,118,114,91,121,107,118,118,34.74425887265136,202001
南砂店,1306,1091,215,975,331,967,339,128,128,116,98,136,124,100,115,113,126,122,34.55087076076994,202001
南足柄店,1033,857,176,783,250,766,267,88,91,103,87,98,89,86,97,83,108,103,33.5075845974329,202001
厚木店,1484,1189,295,1062,422,1102,382,140,134,133,130,131,120,154,144,138,128,132,34.71320437342305,202001
取手店,1188,988,200,881,307,881,307,89,110,103,108,115,112,95,112,106,123,115,33.76417004048583,202001
向島店,1058,876,182,783,275,787,271,109,97,105,96,89,103,104,77,99,87,92,34.09018264840183,202001
君津店,1125,948,177,806,319,836,289,80,90,113,100,97,106,104,90,98,123,124,34.7162447257384,202001
和光店,1338,1096,242,1012,326,994,344,116,130,115,119,106,124,128,152,120,95,133,34.85766423357664,202001
品川店,1487,1225,262,1078,409,1105,382,131,122,134,132,139,126,146,144,135,142,136,34.83265306122449,202001
四街道店,843,687,156,637,206,628,215,75,90,84,73,79,72,70,74,67,78,81,35.01892285298399,202001
国分寺店,1002,820,182,751,251,745,257,77,74,95,92,102,108,105,80,90,89,90,35.00487804878049,202001
国立店,1392,1134,258,1018,374,1036,356,141,120,120,129,122,130,120,118,114,151,127,34.00970017636684,202001
坂戸店,1185,957,228,920,265,881,304,98,122,101,94,111,110,119,111,128,103,88,34.34169278996865,202001
墨田店,1002,811,191,734,268,742,260,86,98,96,81,85,93,90,89,94,105,85,35.458692971639955,202001
多摩店,1102,908,194,793,309,818,284,91,102,101,110,103,98,100,96,91,102,108,34.73348017621145,202001
大久保店,1056,874,182,780,276,783,273,94,107,102,91,93,101,102,100,88,96,82,35.19908466819222,202001
大井店,1217,983,234,900,317,901,316,101,102,123,110,126,105,106,114,119,104,107,34.43641912512716,202001
大和店,1370,1097,273,1013,357,1018,352,125,112,124,119,118,136,126,119,116,148,127,34.030082041932545,202001
大塚店,1127,931,196,834,293,835,292,119,100,91,95,115,101,112,103,85,101,105,35.44253490870033,202001
大宮店,1373,1119,254,1003,370,1019,354,131,143,123,128,131,124,99,123,118,126,127,34.50312779267203,202001
大森店,1428,1149,279,1055,373,1060,368,122,110,131,125,156,149,138,136,104,125,132,34.215839860748474,202001
大泉店,1214,971,243,909,305,900,314,117,111,111,117,107,116,111,103,90,118,113,34.538619979402675,202001
大田店,948,754,194,715,233,705,243,77,76,101,87,74,80,94,93,93,91,82,33.54509283819629,202001
太田店,1373,1098,275,994,379,1016,357,106,116,111,136,135,130,136,108,134,127,134,33.99635701275046,202001
宇都宮店,1090,889,201,801,289,806,284,99,103,90,92,97,109,91,100,99,102,108,33.87064116985377,202001
守谷店,1187,979,208,906,281,880,307,119,108,116,102,96,99,112,100,102,111,122,34.351378958120534,202001
宮前店,726,589,137,538,188,536,190,72,63,64,64,68,58,62,75,69,62,69,34.94736842105263,202001
富岡店,1104,908,196,832,272,820,284,108,115,106,125,87,84,117,99,78,78,107,35.48788546255506,202001
富津店,1040,849,191,779,261,772,268,100,88,89,100,114,83,109,82,92,105,78,33.71731448763252,202001
富里店,1487,1196,291,1107,380,1102,385,121,140,122,149,147,130,162,147,139,116,114,34.274247491638796,202001
小山店,1038,821,217,766,272,773,265,86,109,97,102,73,87,94,92,97,106,95,34.66869671132765,202001
小平店,1001,830,171,740,261,742,259,85,83,102,102,92,91,93,98,84,89,82,33.55301204819277,202001
小田原店,914,735,179,671,243,677,237,83,91,95,90,79,79,77,81,79,67,93,33.72517006802721,202001
小金井店,1094,886,208,805,289,814,280,92,98,82,97,99,100,108,95,115,103,105,34.03950338600451,202001
川口店,1118,928,190,815,303,828,290,94,113,107,100,88,100,98,100,111,89,118,34.34159482758621,202001
川崎多摩店,1132,947,185,833,299,840,292,96,107,100,119,114,106,107,96,108,90,89,33.87856388595565,202001
川崎店,1221,977,244,909,312,907,314,110,107,102,121,93,129,101,126,113,103,116,46.7195496417605,202001
川越店,1158,945,213,883,275,858,300,114,103,109,106,111,100,84,112,96,103,120,48.12592592592594,202001
巣鴨店,1516,1238,278,1121,395,1124,392,179,143,135,113,124,158,139,146,127,124,128,34.45718901453958,202001
市原店,1185,971,214,861,324,881,304,114,110,103,107,120,118,100,122,98,105,88,34.16374871266736,202001
市川店,1189,942,247,864,325,880,309,99,121,108,118,114,123,104,92,96,104,110,47.63057324840764,202001
平塚店,1186,973,213,888,298,884,302,113,118,93,107,111,98,109,107,105,133,92,34.104830421377194,202001
幸店,1426,1159,267,1067,359,1053,373,138,133,118,141,129,112,106,129,150,127,143,34.30025884383089,202001
府中店,1238,1007,231,921,317,923,315,118,104,125,110,117,114,95,108,115,113,119,34.92154915590864,202001
座間店,1369,1099,270,1030,339,1013,356,136,141,114,114,128,123,133,120,131,113,116,34.685168334849855,202001
志木店,915,745,170,658,257,682,233,76,83,94,89,81,77,83,72,98,79,83,34.66845637583893,202001
恵比寿店,1024,845,179,789,235,759,265,83,79,98,88,83,88,93,105,96,100,111,20.27337278106509,202001
愛甲店,1065,880,185,781,284,788,277,102,90,87,93,105,112,89,94,91,96,106,34.57272727272727,202001
成城店,1363,1128,235,1029,334,1011,352,115,127,111,129,122,137,123,120,135,131,113,34.74556737588652,202001
成田店,882,737,145,655,227,658,224,74,77,72,87,83,69,105,70,87,95,63,34.62686567164179,202001
我孫子店,1123,931,192,850,273,833,290,105,87,93,101,107,107,107,111,109,95,101,19.61546723952739,202001
戸塚店,1549,1266,283,1126,423,1150,399,142,149,154,130,116,146,169,134,134,137,138,34.28593996840442,202001
戸田店,1552,1227,325,1159,393,1150,402,128,126,140,138,130,146,139,158,153,153,141,35.42950285248574,202001
所沢店,1183,965,218,863,320,879,304,102,108,116,88,107,118,124,94,109,115,102,34.134715025906736,202001
新宿店,1102,911,191,802,300,817,285,101,105,92,103,104,84,112,114,96,97,94,34.411635565312835,202001
新座店,1030,824,206,788,242,767,263,90,86,81,103,93,112,88,100,80,97,100,35.03155339805825,202001
日本橋店,1451,1206,245,1073,378,1078,373,136,140,126,109,153,131,122,143,139,137,115,34.504145936981764,202001
日立店,1300,1059,241,956,344,963,337,127,116,115,118,117,132,131,101,93,129,121,34.67610953729934,202001
日野店,1153,959,194,867,286,853,300,118,99,96,93,93,109,119,114,110,93,109,34.47028154327425,202001
旭店,1245,1009,236,916,329,925,320,115,117,113,120,98,125,112,112,120,99,114,33.934588701684845,202001
春日部店,1177,960,217,865,312,870,307,108,107,127,106,97,111,118,100,110,104,89,33.984375,202001
昭島店,1205,977,228,895,310,899,306,108,108,128,104,108,103,101,124,100,122,99,34.62436028659161,202001
木更津店,1131,918,213,837,294,838,293,107,99,101,84,115,98,116,103,103,116,89,34.06318082788671,202001
本庄店,1192,962,230,877,315,887,305,135,86,120,88,100,124,121,100,128,95,95,34.63201663201663,202001
本郷店,759,609,150,569,190,564,195,63,62,69,73,64,69,64,65,64,85,81,48.43349753694582,202001
杉並店,1250,1022,228,942,308,927,323,124,101,100,121,110,106,119,122,108,124,115,34.73385518590998,202001
東中野店,1431,1160,271,1068,363,1063,368,123,127,131,141,119,151,125,132,127,142,113,34.05344827586207,202001
東久留米店,883,733,150,645,238,655,228,70,87,84,82,85,88,69,89,62,73,94,34.65075034106412,202001
東大和店,1091,893,198,804,287,813,278,96,97,96,100,101,93,99,100,113,95,101,35.56662933930571,202001
東尾久店,1220,984,236,877,343,907,313,111,108,97,128,110,103,106,113,115,114,115,35.08536585365854,202001
東村山店,1062,850,212,797,265,788,274,90,92,101,94,105,89,110,85,99,91,106,35.33294117647059,202001
東松山店,1333,1095,238,997,336,990,343,131,129,138,110,114,115,115,106,141,123,111,35.35890410958904,202001
松戸店,1254,1033,221,924,330,930,324,115,143,98,114,110,125,106,107,100,115,121,34.72507260406583,202001
板橋店,1093,859,234,788,305,813,280,98,94,95,92,102,97,102,108,94,93,118,47.92898719441211,202001
柏店,1514,1234,280,1109,405,1129,385,149,144,136,134,122,130,140,138,130,154,137,34.35413290113452,202001
栃木店,1090,891,199,847,243,810,280,77,104,90,100,109,106,87,105,102,104,106,34.52861952861953,202001
栄店,1586,1321,265,1149,437,1180,406,136,159,129,159,146,148,149,140,142,133,145,20.322482967448906,202001
桐生店,1245,1009,236,893,352,923,322,125,108,108,114,114,102,135,124,112,95,108,34.33994053518335,202001
横浜南店,1426,1179,247,1077,349,1058,368,116,123,133,130,119,132,126,151,130,127,139,33.635284139100925,202001
横浜緑店,1320,1066,254,949,371,980,340,118,97,119,99,118,116,124,136,128,147,118,34.75234521575985,202001
横須賀店,1097,897,200,811,286,814,283,100,92,97,108,92,95,121,95,92,101,104,35.26532887402453,202001
武蔵村山店,1311,1059,252,977,334,973,338,96,125,123,129,114,128,117,129,122,102,126,33.96600566572238,202001
武蔵野店,1092,897,195,812,280,809,283,91,86,103,102,91,97,115,106,100,96,105,33.80156075808249,202001
水戸店,1393,1126,267,1056,337,1035,358,143,107,122,122,124,110,121,146,143,138,117,34.3392539964476,202001
江戸川店,1186,977,209,878,308,880,306,116,122,105,105,82,107,109,107,113,95,125,34.159672466734904,202001
江東店,1249,1025,224,927,322,927,322,88,112,130,123,117,135,97,117,111,110,109,33.729756097560966,202001
池尻店,1211,990,221,878,333,897,314,115,104,112,119,135,108,103,114,101,90,110,34.279797979797976,202001
池袋店,1461,1215,246,1061,400,1085,376,140,126,137,117,137,153,129,126,139,127,130,34.76543209876543,202001
泉店,1490,1244,246,1104,386,1103,387,133,132,122,153,160,106,133,137,130,146,138,34.31993569131833,202001
流山店,1522,1250,272,1141,381,1130,392,154,123,141,151,150,149,111,136,154,129,124,34.844,202001
浅草店,1388,1127,261,1031,357,1034,354,150,126,119,126,122,118,135,139,118,118,117,35.069210292812784,202001
浦和店,1294,1066,228,959,335,960,334,104,122,109,103,138,119,96,139,140,107,117,35.363977485928714,202001
浦安店,1332,1084,248,976,356,986,346,102,103,127,113,125,115,125,142,119,131,130,34.626383763837644,202001
海老名店,1183,972,211,878,305,879,304,112,115,110,110,109,105,107,116,96,98,105,33.86008230452675,202001
清瀬店,1059,844,215,766,293,785,274,101,96,103,75,97,100,91,100,102,95,99,35.31753554502369,202001
渋谷店,1158,958,200,853,305,860,298,105,103,102,100,102,89,115,133,103,97,109,34.65657620041754,202001
港北店,1040,886,154,764,276,770,270,95,83,94,99,105,98,116,86,94,88,82,20.118510158013546,202001
港南店,1239,1022,217,902,337,914,325,113,110,115,105,97,118,90,128,120,118,125,34.711350293542075,202001
瀬谷店,1455,1187,268,1122,333,1079,376,137,109,119,116,145,137,146,139,142,130,135,34.206402695871944,202001
熊谷店,1126,917,209,865,261,832,294,102,90,97,97,125,109,113,106,88,101,98,33.55070883315158,202001
狛江店,1245,1018,227,928,317,921,324,102,123,116,122,119,124,108,110,111,107,103,35.31139489194499,202001
狭山店,1423,1141,282,1058,365,1061,362,129,115,120,131,120,136,130,128,136,141,137,35.422436459246285,202001
王子店,1152,962,190,831,321,858,294,114,106,90,100,95,117,111,84,109,121,105,20.6018711018711,202001
町田店,1339,1109,230,994,345,991,348,128,116,113,130,119,139,117,109,131,115,122,34.0117222723174,202001
白井店,1096,875,221,788,308,814,282,105,106,104,83,102,98,92,108,110,102,86,47.544,202001
目黒店,1221,1008,213,907,314,912,309,99,109,115,118,120,120,103,115,121,102,99,34.47222222222222,202001
相模原店,1483,1207,276,1089,394,1100,383,122,133,141,141,150,116,133,119,131,129,168,34.77299088649544,202001
石神井店,972,772,200,734,238,721,251,72,94,85,86,89,80,84,110,85,101,86,47.411917098445606,202001
磯子店,945,788,157,699,246,698,247,89,90,88,83,92,95,73,92,79,87,77,34.94796954314721,202001
神奈川店,1407,1128,279,1046,361,1045,362,128,125,141,126,138,115,144,128,115,131,116,33.929964539007095,202001
神田店,1450,1195,255,1102,348,1081,369,151,128,108,132,144,130,132,127,126,133,139,34.74728033472803,202001
福生店,1360,1103,257,1007,353,1008,352,144,117,123,114,116,122,114,131,127,116,136,34.681776971894834,202001
秦野店,1243,1027,216,899,344,922,321,115,108,110,122,102,117,118,106,134,109,102,34.23855890944498,202001
稲城店,969,771,198,714,255,722,247,66,89,103,79,97,80,88,94,90,92,91,48.762645914396884,202001
立川店,1304,1060,244,982,322,970,334,118,134,139,110,126,97,124,97,136,117,106,34.5433962264151,202001
綾瀬店,2694,2169,525,1964,730,2003,691,232,254,244,249,232,277,226,238,233,262,247,34.5850622406639,202001
練馬店,1421,1162,259,1071,350,1057,364,115,126,129,110,113,127,147,152,127,127,148,34.703098106712574,202001
羽村店,1404,1154,250,1049,355,1045,359,130,117,124,136,136,122,126,132,138,119,124,20.246967071057192,202001
羽生店,1325,1073,252,976,349,985,340,134,108,132,117,102,140,123,125,129,101,114,34.73438956197577,202001
習志野店,1435,1163,272,1051,384,1064,371,138,121,143,133,143,135,126,116,147,113,120,34.2055030094583,202001
自由が丘店,1313,1086,227,971,342,974,339,129,122,121,106,134,122,120,105,107,136,111,34.36556169429097,202001
船橋店,1483,1196,287,1087,396,1104,379,126,120,150,148,128,133,143,134,138,141,122,34.852842809364546,202001
若葉店,1189,988,201,883,306,884,305,101,105,102,133,117,101,103,101,110,99,117,34.67914979757085,202001
茂原店,1376,1128,248,1028,348,1020,356,91,126,130,136,116,132,123,138,132,115,137,33.662234042553195,202001
茅ヶ崎店,916,744,172,671,245,678,238,89,85,81,86,98,61,96,82,88,73,77,34.997311827956985,202001
草加店,1010,829,181,734,276,750,260,97,115,75,98,89,89,116,86,86,81,78,34.78528347406514,202001
荒川店,909,746,163,684,225,674,235,73,89,80,86,96,81,86,90,73,72,83,34.62332439678284,202001
荻窪店,1242,1029,213,923,319,921,321,116,105,138,105,118,115,113,108,103,108,113,19.96793002915452,202001
葛飾店,1156,931,225,866,290,857,299,98,78,112,110,119,125,109,115,80,110,100,34.32223415682062,202001
蒲田店,1032,825,207,776,256,765,267,105,104,89,90,90,78,100,105,86,86,99,35.315151515151506,202001
藤沢店,1186,975,211,877,309,882,304,113,121,93,102,119,137,104,106,117,87,87,34.540512820512824,202001
行田店,1004,803,201,765,239,744,260,82,102,81,99,106,85,70,94,97,99,89,35.36612702366128,202001
西多摩店,1585,1287,298,1172,413,1176,409,140,137,164,167,120,142,133,146,141,130,165,34.623154623154626,202001
西東京店,1001,825,176,743,258,745,256,88,86,89,112,81,80,94,86,92,99,94,34.75030303030303,202001
西葛西店,819,682,137,629,190,608,211,66,81,75,75,79,75,70,90,71,67,70,34.442815249266864,202001
調布店,1428,1172,256,1046,382,1057,371,116,126,122,107,155,140,152,121,141,128,120,34.891638225255974,202001
谷中店,1553,1260,293,1163,390,1149,404,132,146,160,137,161,155,143,151,143,117,108,33.93571428571428,202001
赤坂店,1035,852,183,766,269,771,264,100,87,100,102,82,105,79,78,103,98,101,34.481220657276985,202001
赤羽店,1181,939,242,852,329,879,302,116,102,117,131,109,113,89,85,111,112,96,46.98189563365282,202001
越谷店,914,754,160,683,231,676,238,86,87,81,86,97,66,67,90,92,83,79,47.248010610079575,202001
足利店,822,695,127,622,200,609,213,75,69,77,78,59,80,73,87,72,83,69,35.10647482014389,202001
足柄上店,1248,1014,234,913,335,925,323,115,107,132,109,115,120,127,101,102,109,111,33.83727810650888,202001
足立店,877,721,156,639,238,650,227,61,72,89,81,84,75,83,85,90,63,94,33.45214979195562,202001
逗子店,1090,891,199,800,290,808,282,112,84,90,107,104,106,94,102,102,93,96,34.46127946127946,202001
那珂店,1219,1010,209,882,337,902,317,113,128,117,116,102,108,116,100,98,120,101,20.77623762376237,202001
都筑店,1042,845,197,784,258,773,269,82,120,90,100,69,81,110,98,101,92,99,34.69585798816568,202001
金沢店,1272,1064,208,944,328,945,327,108,117,110,119,92,118,130,128,124,108,118,20.155075187969924,202001
銀座店,998,830,168,761,237,737,261,82,111,88,87,101,96,70,82,94,90,97,35.302409638554224,202001
鎌倉店,1009,817,192,746,263,748,261,100,98,87,90,90,84,84,96,90,100,90,34.54834761321909,202001
青山店,1377,1118,259,993,384,1021,356,130,93,123,123,149,125,140,118,125,140,111,35.093023255813954,202001
青梅店,1281,1036,245,929,352,950,331,118,98,99,126,117,108,136,129,102,127,121,35.16602316602317,202001
青葉店,1151,944,207,877,274,857,294,110,105,90,94,103,131,108,107,91,105,107,34.4396186440678,202001
館林店,1182,956,226,864,318,878,304,122,102,119,96,109,103,104,103,97,115,112,34.456066945606686,202001
駒沢店,1034,858,176,763,271,769,265,79,104,78,102,88,106,96,97,104,88,92,34.75524475524475,202001
駒込店,1488,1210,278,1061,427,1104,384,136,139,131,143,138,137,137,113,134,144,136,33.89090909090909,202001
高円寺店,1428,1175,253,1072,356,1054,374,131,128,122,140,114,130,142,117,121,156,127,34.36510638297872,202001
高島平店,1240,1005,235,917,323,918,322,145,109,108,96,115,109,116,101,105,109,127,34.971144278606964,202001
高崎店,1150,948,202,833,317,851,299,108,115,106,100,117,107,109,101,93,96,98,34.562236286919834,202001
高座店,1147,942,205,846,301,848,299,107,103,95,121,79,107,94,119,101,116,105,33.90658174097665,202001
高津店,1152,950,202,844,308,858,294,104,108,90,111,120,95,104,101,108,115,96,34.312631578947375,202001
高田馬場店,1100,903,197,801,299,820,280,96,86,82,94,93,107,111,118,112,95,106,34.96899224806201,202001
鴻巣店,1150,930,220,864,286,854,296,108,93,115,104,110,99,100,107,103,114,97,35.255913978494625,202001
鶴見店,1527,1237,290,1120,407,1132,395,130,149,127,144,138,151,126,132,137,153,140,34.32336297493937,202001
麻生店,1391,1150,241,1052,339,1031,360,114,125,133,131,125,105,124,122,128,136,148,34.04347826086956,202001
あきる野店,1106,893,213,819,287,762,344,107,89,106,111,98,90,102,94,97,101,111,34.820828667413224,202002
さいたま南店,1442,1169,273,1082,360,996,446,110,135,148,127,143,132,148,113,143,124,119,34.02651839178785,202002
さいたま緑店,994,787,207,727,267,684,310,92,81,91,91,102,90,83,93,79,93,99,34.3151207115629,202002
さいたま西店,1147,968,179,839,308,791,356,92,98,93,109,94,125,101,111,103,112,109,34.52685950413223,202002
つくば店,1227,988,239,901,326,846,381,108,130,124,110,122,94,110,116,97,101,115,34.99291497975708,202002
三浦店,1099,887,212,817,282,757,342,111,112,96,102,99,101,81,91,96,106,104,33.89853438556933,202002
三鷹店,1460,1181,279,1088,372,1012,448,146,115,129,131,134,122,124,146,131,145,137,34.723962743437774,202002
上尾店,1279,1040,239,943,336,885,394,107,110,120,126,127,111,112,143,94,112,117,20.16634615384616,202002
上野店,1561,1285,276,1122,439,1078,483,162,135,141,139,136,146,128,134,173,105,162,35.02178988326848,202002
世田谷店,1481,1211,270,1108,373,1025,456,110,147,123,148,141,123,134,132,144,128,151,34.51857968620974,202002
中原店,1484,1200,284,1123,361,1024,460,148,139,120,140,122,145,127,138,125,133,147,34.56583333333333,202002
中店,1169,966,203,882,287,805,364,126,96,112,106,96,111,99,98,115,119,91,34.34057971014493,202002
中野店,1112,912,200,814,298,767,345,125,100,123,102,97,98,93,89,93,100,92,35.14144736842105,202002
久喜店,1246,1009,237,921,325,858,388,114,137,118,112,115,111,111,113,95,111,109,35.070366699702674,202002
九段店,1272,1045,227,939,333,873,399,106,129,121,109,113,112,126,112,115,109,120,35.11770334928229,202002
亀有店,985,773,212,721,264,679,306,83,84,94,89,74,97,91,100,85,98,90,34.853816300129374,202002
五反田店,1107,910,197,797,310,760,347,92,117,101,89,101,95,95,111,118,97,91,34.77252747252747,202002
代々木店,1306,1057,249,953,353,897,409,125,116,110,132,104,118,115,111,121,109,145,34.55534531693472,202002
伊勢原店,1397,1143,254,1035,362,962,435,136,115,111,122,135,116,124,141,159,106,132,34.45844269466317,202002
伊勢崎店,1540,1265,275,1136,404,1060,480,148,166,145,151,136,154,131,115,137,125,132,34.66403162055336,202002
佐倉店,856,695,161,663,193,593,263,78,93,76,75,80,78,74,85,74,78,65,35.566906474820144,202002
佐野店,1452,1166,286,1071,381,1000,452,119,136,139,138,117,129,127,140,137,138,132,34.60548885077187,202002
保土ケ谷店,1223,996,227,890,333,843,380,96,106,117,114,95,131,123,121,99,113,108,33.64156626506024,202002
入間店,1108,892,216,824,284,766,342,108,90,96,109,108,103,113,92,95,98,96,34.27017937219731,202002
八千代店,1197,971,226,894,303,825,372,108,102,89,126,103,108,123,120,100,98,120,34.20494335736354,202002
八潮店,1165,951,214,852,313,804,361,109,101,98,109,103,112,106,111,120,101,95,34.57202944269191,202002
八王子店,1479,1206,273,1113,366,1018,461,129,129,136,124,148,135,126,142,135,142,133,33.64759535655058,202002
六本木店,968,803,165,689,279,671,297,73,94,92,95,98,91,80,93,78,75,99,35.23038605230387,202002
前橋店,794,641,153,578,216,547,247,60,56,82,78,76,62,76,60,86,79,79,33.92979719188767,202002
北千住店,962,784,178,728,234,664,298,90,96,82,64,78,97,94,102,87,73,99,34.58418367346939,202002
千葉中央店,1220,1011,209,888,332,841,379,102,116,107,124,87,128,108,113,95,114,126,34.267062314540055,202002
千葉緑店,1110,913,197,785,325,769,341,89,111,107,98,99,107,99,107,89,112,92,34.397590361445786,202002
南砂店,1216,1001,215,876,340,835,381,115,112,109,113,111,103,124,101,114,111,103,34.45154845154845,202002
南足柄店,966,794,172,724,242,671,295,80,95,87,87,91,101,83,94,88,75,85,34.948362720403026,202002
厚木店,1393,1133,260,1046,347,957,436,142,122,125,141,121,114,126,120,118,151,113,34.34333627537511,202002
取手店,1116,896,220,823,293,769,347,98,96,118,99,108,110,106,96,93,106,86,34.841517857142854,202002
向島店,996,818,178,739,257,688,308,104,71,119,86,68,78,94,104,90,87,95,34.4718826405868,202002
君津店,1055,861,194,764,291,729,326,82,98,96,103,85,91,107,95,96,110,92,35.14982578397213,202002
和光店,1257,1046,211,924,333,870,387,122,113,121,117,98,106,121,104,120,110,125,34.317399617590816,202002
品川店,1389,1129,260,1010,379,960,429,111,147,128,120,135,121,114,131,112,125,145,34.344552701505755,202002
四街道店,794,654,140,602,192,549,245,69,63,70,69,86,69,58,74,78,78,80,33.6651376146789,202002
国分寺店,941,775,166,688,253,648,293,73,91,85,97,87,72,85,100,96,74,81,34.34967741935484,202002
国立店,1301,1068,233,989,312,898,403,115,123,127,130,116,114,123,108,99,123,123,34.842696629213485,202002
坂戸店,1100,914,186,824,276,758,342,97,95,88,104,97,97,103,120,87,107,105,33.803063457330424,202002
墨田店,934,778,156,689,245,644,290,90,78,91,96,79,81,78,101,82,84,74,34.35218508997429,202002
多摩店,1020,829,191,778,242,702,318,89,93,96,92,81,90,99,104,101,92,83,34.27141133896261,202002
大久保店,1001,803,198,753,248,693,308,93,81,98,96,93,95,82,84,92,103,84,34.52926525529265,202002
大井店,1134,925,209,816,318,781,353,99,100,104,119,112,112,96,107,88,95,102,35.26054054054054,202002
大和店,1271,1027,244,947,324,879,392,114,113,112,111,128,120,121,106,100,127,119,33.888997078870496,202002
大塚店,1056,867,189,786,270,727,329,94,88,97,104,79,86,99,106,105,90,108,33.38292964244521,202002
大宮店,1275,1073,202,942,333,882,393,120,97,130,120,117,100,125,114,103,129,120,34.54054054054054,202002
大森店,1339,1105,234,980,359,925,414,103,116,150,120,120,124,123,111,128,126,118,34.56651583710407,202002
大泉店,1142,936,206,823,319,787,355,95,104,107,94,103,108,125,87,90,116,113,34.246794871794876,202002
大田店,884,709,175,661,223,610,274,85,72,91,78,74,71,74,82,93,79,85,34.79407616361072,202002
太田店,1275,1057,218,953,322,884,391,124,112,138,114,108,102,105,120,106,117,129,34.57332071901608,202002
宇都宮店,1020,835,185,754,266,703,317,81,97,106,84,75,96,80,92,115,92,102,33.7245508982036,202002
守谷店,1113,952,161,828,285,770,343,90,94,109,109,115,103,101,83,107,93,109,34.53991596638655,202002
宮前店,676,546,130,513,163,464,212,72,54,67,54,78,49,49,57,64,68,64,33.615384615384606,202002
富岡店,1028,815,213,759,269,708,320,97,105,87,101,66,97,100,86,102,88,99,35.011042944785274,202002
富津店,971,804,167,731,240,672,299,91,84,96,76,108,79,90,73,83,99,92,33.460199004975124,202002
富里店,1395,1149,246,1077,318,961,434,130,115,126,114,128,116,133,122,132,144,135,34.90774586597041,202002
小山店,971,810,161,737,234,669,302,80,104,91,92,82,89,89,71,81,85,107,35.30246913580247,202002
小平店,944,777,167,715,229,654,290,68,85,86,85,81,88,87,98,73,101,92,35.21750321750321,202002
小田原店,849,705,144,622,227,588,261,92,75,75,70,80,87,68,71,79,82,70,34.77163120567376,202002
小金井店,1026,832,194,753,273,705,321,93,106,82,92,102,90,87,101,90,94,89,34.153846153846146,202002
川口店,1057,863,194,771,286,727,330,97,99,92,104,103,97,104,76,101,88,96,34.684820393974505,202002
川崎多摩店,1051,845,206,780,271,724,327,90,112,88,82,99,80,89,93,112,96,110,34.46272189349112,202002
川崎店,1128,910,218,843,285,777,351,111,112,97,100,94,86,108,99,87,106,128,48.66593406593407,202002
川越店,1077,857,220,793,284,742,335,98,107,116,87,94,93,107,87,91,103,94,47.44574095682614,202002
巣鴨店,1429,1167,262,1061,368,989,440,121,125,129,120,141,130,143,141,111,129,139,34.747215081405315,202002
市原店,1114,898,216,823,291,769,345,102,102,86,99,114,117,89,104,96,107,98,33.49109131403118,202002
市川店,1112,881,231,820,292,767,345,105,112,83,91,95,107,100,100,104,96,119,47.44494892167991,202002
平塚店,1102,868,234,810,292,763,339,112,91,108,112,101,112,100,105,87,85,89,34.35138248847926,202002
幸店,1340,1068,272,996,344,925,415,130,133,124,129,129,119,117,120,122,113,104,35.012172284644194,202002
府中店,1170,958,212,855,315,808,362,97,105,115,88,115,121,112,102,106,98,111,34.32359081419625,202002
座間店,1277,1062,215,934,343,887,390,115,108,123,109,115,116,128,110,114,111,128,34.336158192090394,202002
志木店,848,666,182,641,207,585,263,80,92,77,78,75,80,73,75,71,63,84,35.08108108108108,202002
恵比寿店,976,821,155,717,259,672,304,87,86,87,73,103,82,101,96,85,85,91,20.32277710109623,202002
愛甲店,992,823,169,752,240,687,305,94,92,73,87,79,96,84,86,101,103,97,34.098420413122724,202002
成城店,1284,1032,252,926,358,884,400,116,104,91,120,126,128,135,127,108,119,110,34.061046511627914,202002
成田店,830,696,134,608,222,573,257,72,74,69,70,74,75,73,78,79,94,72,33.8117816091954,202002
我孫子店,1055,875,180,775,280,729,326,93,105,88,104,85,99,103,90,91,95,102,20.00228571428572,202002
戸塚店,1442,1185,257,1068,374,993,449,125,135,133,137,131,131,146,127,130,116,131,34.04810126582279,202002
戸田店,1444,1177,267,1087,357,996,448,120,111,133,147,139,151,99,123,123,174,124,34.429906542056074,202002
所沢店,1114,905,209,833,281,769,345,102,105,107,98,89,96,103,101,98,112,103,34.573480662983435,202002
新宿店,1023,839,184,762,261,704,319,88,94,92,92,86,93,110,97,86,98,87,35.35637663885578,202002
新座店,969,799,170,721,248,670,299,80,91,100,86,100,83,76,98,95,78,82,33.67584480600751,202002
日本橋店,1371,1092,279,1005,366,947,424,127,128,122,121,125,126,121,102,125,129,145,34.9496336996337,202002
日立店,1224,997,227,892,332,844,380,115,104,116,120,126,95,106,102,125,101,114,34.302908726178536,202002
日野店,1086,890,196,788,298,748,338,91,110,77,97,112,91,106,85,105,103,109,34.731460674157304,202002
旭店,1166,946,220,868,298,806,360,106,99,106,105,126,104,114,111,103,94,98,34.71353065539112,202002
春日部店,1115,902,213,834,281,766,349,104,107,92,109,96,101,81,103,109,108,105,35.185144124168524,202002
昭島店,1132,927,205,838,294,782,350,89,93,105,105,100,111,107,107,122,88,105,33.74110032362459,202002
木更津店,1057,877,180,789,268,726,331,91,94,107,100,107,86,100,80,100,99,93,34.96807297605473,202002
本庄店,1108,880,228,811,297,767,341,112,107,108,93,108,102,96,99,94,86,103,35.00909090909091,202002
本郷店,712,581,131,501,211,491,221,68,63,53,60,64,68,56,74,63,69,74,46.39931153184165,202002
杉並店,1167,962,205,888,279,802,365,103,120,112,101,118,116,99,83,108,97,110,33.7027027027027,202002
東中野店,1337,1105,232,969,368,922,415,123,118,127,146,113,122,116,120,111,125,116,34.42533936651584,202002
東久留米店,819,673,146,579,240,561,258,67,81,81,74,83,72,71,70,74,66,80,34.815750371471026,202002
東大和店,1029,849,180,759,270,708,321,89,106,95,89,82,88,93,100,106,90,91,35.180212014134284,202002
東尾久店,1131,950,181,853,278,776,355,98,86,100,98,122,93,111,98,100,111,114,33.933684210526316,202002
東村山店,999,828,171,741,258,690,309,84,84,100,93,82,82,93,85,99,110,87,33.710144927536234,202002
東松山店,1247,1010,237,956,291,864,383,107,123,119,115,126,101,112,119,117,108,100,34.02376237623762,202002
松戸店,1167,939,228,865,302,801,366,102,101,96,109,107,131,100,113,115,89,104,33.72949946751864,202002
板橋店,1018,809,209,774,244,701,317,96,94,91,83,92,101,98,102,95,78,88,46.81087762669963,202002
柏店,1430,1158,272,1081,349,983,447,149,111,124,132,114,129,126,107,142,142,154,34.317789291882555,202002
栃木店,1022,828,194,741,281,703,319,85,105,81,91,92,95,93,102,103,70,105,34.31521739130435,202002
栄店,1471,1208,263,1084,387,1015,456,139,119,125,146,139,121,123,121,147,138,153,20.52566225165563,202002
桐生店,1166,948,218,858,308,804,362,94,107,115,118,97,100,113,107,109,101,105,34.176160337552744,202002
横浜南店,1337,1102,235,1015,322,922,415,135,123,113,119,119,138,129,106,109,121,125,35.348457350272234,202002
横浜緑店,1228,1008,220,906,322,846,382,111,125,116,99,108,104,115,129,111,108,102,34.32539682539682,202002
横須賀店,1014,813,201,737,277,699,315,81,72,92,99,95,104,94,90,93,96,98,34.645756457564566,202002
武蔵村山店,1227,1005,222,898,329,848,379,110,118,137,90,99,111,107,116,109,112,118,34.57910447761194,202002
武蔵野店,1024,863,161,761,263,708,316,88,93,91,103,103,94,102,94,81,75,100,34.762456546929315,202002
水戸店,1314,1074,240,959,355,909,405,121,128,130,118,117,128,120,110,109,118,115,34.84357541899441,202002
江戸川店,1112,891,221,819,293,768,344,109,100,107,101,95,102,104,100,99,98,97,34.45791245791246,202002
江東店,1162,964,198,890,272,801,361,107,113,109,109,107,103,110,98,95,100,111,34.50829875518672,202002
池尻店,1132,937,195,873,259,784,348,98,116,88,91,109,104,108,99,103,105,111,34.209178228388474,202002
池袋店,1372,1096,276,993,379,945,427,130,131,130,117,108,142,120,127,112,140,115,33.807481751824824,202002
泉店,1387,1118,269,1028,359,955,432,141,139,145,123,121,139,123,120,103,119,114,34.31305903398927,202002
流山店,1421,1162,259,1059,362,978,443,124,128,130,120,126,125,130,147,118,154,119,33.09724612736661,202002
浅草店,1304,1052,252,942,362,902,402,130,103,112,124,108,122,133,125,114,115,118,34.45342205323194,202002
浦和店,1220,1004,216,920,300,841,379,114,114,130,115,100,89,106,117,128,108,99,35.157370517928285,202002
浦安店,1247,1014,233,928,319,861,386,106,115,116,120,98,128,130,125,106,110,93,34.34714003944773,202002
海老名店,1113,921,192,831,282,765,348,115,100,99,96,112,119,89,92,106,103,82,34.5700325732899,202002
清瀬店,995,829,166,749,246,687,308,98,90,95,99,79,83,83,103,91,87,87,33.98431845597105,202002
渋谷店,1076,880,196,803,273,741,335,94,97,91,96,109,105,102,98,81,100,103,34.49886363636364,202002
港北店,973,808,165,715,258,673,300,92,79,86,92,83,74,77,93,84,126,87,19.42326732673268,202002
港南店,1166,951,215,851,315,805,361,98,121,110,106,107,82,125,98,107,101,111,34.465825446897995,202002
瀬谷店,1368,1119,249,1009,359,940,428,130,126,132,133,136,121,131,123,110,105,121,34.61572832886506,202002
熊谷店,1050,865,185,778,272,722,328,109,96,94,93,92,101,96,95,92,89,93,35.160693641618494,202002
狛江店,1172,971,201,879,293,807,365,102,102,107,89,106,121,113,110,112,91,119,34.13182286302781,202002
狭山店,1327,1083,244,973,354,912,415,113,93,114,115,119,136,122,119,136,127,133,34.715604801477376,202002
王子店,1085,894,191,800,285,747,338,105,87,103,106,100,103,96,83,89,101,112,20.552572706935123,202002
町田店,1249,1021,228,956,293,863,386,121,117,122,116,123,118,109,118,97,102,106,34.5279138099902,202002
白井店,1027,832,195,747,280,707,320,113,88,79,84,95,94,92,104,85,109,84,47.24158653846154,202002
目黒店,1130,925,205,810,320,779,351,95,110,104,99,103,115,115,97,96,110,86,34.38054054054055,202002
相模原店,1396,1125,271,1051,345,967,429,136,122,128,142,119,119,116,118,135,141,120,34.346666666666664,202002
石神井店,903,739,164,669,234,624,279,87,72,76,90,75,87,91,85,80,76,84,48.44248985115021,202002
磯子店,884,724,160,659,225,609,275,68,70,81,85,69,85,77,90,77,90,92,35.136740331491715,202002
神奈川店,1302,1063,239,975,327,895,407,125,121,121,111,119,102,126,120,111,118,128,34.77422389463782,202002
神田店,1369,1128,241,1037,332,943,426,113,134,127,156,123,144,106,124,120,99,123,35.25354609929078,202002
福生店,1285,1037,248,969,316,884,401,85,123,123,143,83,128,138,96,127,114,125,34.66827386692382,202002
秦野店,1171,964,207,852,319,805,366,86,90,98,107,121,123,115,104,95,121,111,34.18153526970954,202002
稲城店,908,729,179,651,257,627,281,87,83,85,78,93,66,87,69,84,85,91,47.526748971193406,202002
立川店,1221,1007,214,911,310,842,379,92,124,111,122,120,106,110,101,125,97,113,35.330685203574966,202002
綾瀬店,2525,2069,456,1884,641,1740,785,222,223,242,229,217,242,241,244,207,237,221,34.20396326727888,202002
練馬店,1332,1093,239,984,348,917,415,120,118,115,121,147,126,116,131,107,116,115,34.604757548032936,202002
羽村店,1305,1086,219,972,333,899,406,108,116,127,126,124,99,118,130,116,120,121,19.90791896869245,202002
羽生店,1244,1002,242,905,339,859,385,117,126,109,107,117,115,105,107,106,130,105,34.64271457085828,202002
習志野店,1343,1081,262,970,373,928,415,115,116,134,118,133,120,120,121,117,118,131,34.3413506012951,202002
自由が丘店,1215,968,247,905,310,838,377,111,103,127,122,118,121,104,93,104,101,111,33.86570247933884,202002
船橋店,1395,1124,271,1034,361,965,430,126,138,93,123,146,150,116,134,119,139,111,34.40035587188612,202002
若葉店,1106,906,200,829,277,760,346,99,107,97,86,97,99,106,115,102,103,95,35.570640176600435,202002
茂原店,1274,1039,235,944,330,881,393,126,117,104,122,123,122,112,103,109,117,119,34.90856592877767,202002
茅ヶ崎店,855,686,169,649,206,591,264,74,75,75,88,72,86,78,90,56,66,95,33.5801749271137,202002
草加店,941,775,166,716,225,649,292,100,81,79,81,92,83,92,92,80,77,84,34.13935483870968,202002
荒川店,854,682,172,641,213,590,264,95,62,99,90,78,78,62,72,67,76,75,34.947214076246325,202002
荻窪店,1160,974,186,841,319,800,360,98,105,112,102,108,107,103,102,112,107,104,20.50308008213552,202002
葛飾店,1072,862,210,786,286,738,334,79,87,118,104,83,107,102,103,96,91,102,34.367749419953604,202002
蒲田店,974,790,184,722,252,671,303,70,107,77,109,93,99,70,87,95,78,89,33.60379746835443,202002
藤沢店,1114,923,191,809,305,767,347,107,95,93,100,98,98,128,93,105,95,102,34.342361863488634,202002
行田店,936,750,186,723,213,640,296,80,77,83,82,88,94,86,91,78,88,89,34.446666666666665,202002
西多摩店,1479,1188,291,1102,377,1023,456,149,139,139,126,144,124,123,141,134,119,141,34.22222222222222,202002
西東京店,934,764,170,692,242,642,292,86,86,98,62,82,73,87,89,89,92,90,35.848167539267024,202002
西葛西店,758,612,146,564,194,522,236,67,66,67,73,64,67,72,75,74,65,68,35.74183006535948,202002
調布店,1331,1087,244,946,385,918,413,113,118,100,126,124,124,128,136,131,114,117,34.69549218031279,202002
谷中店,1453,1168,285,1091,362,1000,453,89,114,152,143,141,148,121,128,132,159,126,34.426369863013704,202002
赤坂店,969,802,167,719,250,667,302,82,84,83,98,82,95,82,95,96,91,81,34.72942643391521,202002
赤羽店,1109,907,202,834,275,762,347,103,97,95,108,97,111,93,105,95,109,96,47.337375964718845,202002
越谷店,858,689,169,644,214,592,266,91,59,76,81,75,70,75,82,73,66,110,46.72278664731495,202002
足利店,766,629,137,578,188,527,239,75,59,77,61,71,62,70,65,68,79,79,34.111287758346585,202002
足柄上店,1163,952,211,851,312,800,363,96,110,96,110,115,107,113,103,116,100,97,34.90756302521008,202002
足立店,818,667,151,591,227,564,254,74,68,76,81,62,81,89,85,69,60,73,34.92203898050975,202002
逗子店,1021,847,174,755,266,709,312,101,75,85,106,91,105,87,91,88,95,97,34.3801652892562,202002
那珂店,1146,947,199,874,272,791,355,118,91,98,114,101,103,93,116,86,103,123,20.633579725448786,202002
都筑店,968,807,161,713,255,668,300,78,89,87,90,74,87,88,93,115,85,82,33.93308550185873,202002
金沢店,1191,995,196,897,294,826,365,108,110,116,118,115,109,106,77,108,109,115,20.191959798994976,202002
銀座店,942,753,189,723,219,650,292,95,71,86,91,87,78,97,84,79,81,93,34.34395750332005,202002
鎌倉店,938,764,174,696,242,649,289,86,88,79,84,83,80,94,95,76,76,97,34.89397905759162,202002
青山店,1277,1028,249,959,318,878,399,106,124,128,97,95,136,97,124,119,134,117,34.39007782101167,202002
青梅店,1184,965,219,853,331,816,368,107,97,122,93,108,107,106,117,98,120,109,33.96062176165803,202002
青葉店,1080,874,206,814,266,744,336,92,102,107,103,103,123,77,97,100,96,80,34.764302059496565,202002
館林店,1110,898,212,814,296,763,347,111,89,90,86,99,107,106,116,92,103,111,34.562360801781736,202002
駒沢店,971,776,195,709,262,672,299,83,84,89,80,93,64,93,84,101,93,107,33.93814432989691,202002
駒込店,1391,1142,249,1010,381,955,436,125,115,133,129,125,142,113,133,141,129,106,34.288966725043785,202002
高円寺店,1339,1072,267,999,340,924,415,125,119,112,134,124,119,123,123,126,120,114,34.28264925373134,202002
高島平店,1165,929,236,842,323,803,362,107,121,112,97,105,97,99,118,98,110,101,34.758880516684606,202002
高崎店,1080,869,211,783,297,749,331,104,102,75,89,95,95,111,101,94,94,120,34.773302646720374,202002
高座店,1071,877,194,802,269,743,328,99,91,72,96,102,121,100,100,84,106,100,33.98175598631698,202002
高津店,1080,878,202,787,293,741,339,87,87,94,99,100,108,102,105,102,103,93,34.21981776765376,202002
高田馬場店,1027,837,190,775,252,709,318,105,101,91,87,96,83,87,96,93,100,88,34.81123058542413,202002
鴻巣店,1074,883,191,791,283,745,329,97,93,102,108,96,100,99,90,105,103,81,33.09060022650057,202002
鶴見店,1424,1199,225,1046,378,985,439,134,116,135,133,131,127,146,124,129,125,124,34.48874061718099,202002
麻生店,1312,1065,247,966,346,903,409,105,118,120,119,116,119,123,117,131,118,126,34.25352112676056,202002
あきる野店,1186,958,228,858,328,839,347,104,107,109,105,113,103,101,106,113,114,111,35.204592901878904,202003
さいたま南店,1553,1266,287,1145,408,1103,450,165,136,140,126,122,150,145,152,151,134,132,35.25908372827804,202003
さいたま緑店,1063,875,188,807,256,754,309,113,82,79,93,108,103,94,100,91,96,104,35.26857142857143,202003
さいたま西店,1219,977,242,911,308,865,354,107,124,120,91,106,104,111,116,103,110,127,34.29477993858751,202003
つくば店,1306,1057,249,976,330,928,378,113,108,120,113,109,123,130,127,125,104,134,34.783349101229895,202003
三浦店,1176,975,201,894,282,831,345,114,101,114,108,106,110,92,102,106,100,123,33.80717948717949,202003
三鷹店,1542,1257,285,1134,408,1092,450,142,133,146,146,119,144,159,134,147,134,138,34.53381066030231,202003
上尾店,1369,1159,210,1014,355,972,397,128,124,105,142,138,116,118,113,118,136,131,20.43399482312337,202003
上野店,1681,1386,295,1263,418,1197,484,152,157,145,164,130,141,156,164,156,166,150,34.60606060606061,202003
世田谷店,1579,1267,312,1173,406,1120,459,148,140,151,133,147,144,149,139,145,120,163,34.67955801104972,202003
中原店,1576,1277,299,1160,416,1115,461,119,141,144,155,142,136,147,146,155,147,144,34.22866092404072,202003
中店,1238,1002,236,937,301,874,364,110,122,103,114,119,108,107,117,120,115,103,34.34231536926148,202003
中野店,1186,962,224,869,317,841,345,93,108,124,119,113,104,106,105,93,117,104,34.485446985446984,202003
久喜店,1334,1118,216,1004,330,944,390,128,130,130,139,110,120,103,109,112,113,140,33.983005366726296,202003
九段店,1362,1120,242,1014,348,965,397,113,146,138,119,127,101,132,123,124,126,113,34.388392857142854,202003
亀有店,1065,861,204,785,280,755,310,98,108,91,83,118,76,92,99,85,108,107,34.335656213704986,202003
五反田店,1188,966,222,866,322,839,349,89,121,82,135,102,127,94,120,95,105,118,34.506211180124225,202003
代々木店,1403,1153,250,1056,347,996,407,129,121,136,132,135,122,125,138,123,104,138,33.86383347788378,202003
伊勢原店,1482,1197,285,1076,406,1052,430,135,150,141,135,126,130,132,137,129,138,129,34.062656641604015,202003
伊勢崎店,1641,1363,278,1215,426,1165,476,126,153,170,131,153,148,132,164,158,155,151,34.06603081438004,202003
佐倉店,918,770,148,668,250,653,265,79,92,84,82,79,76,81,100,89,71,85,33.78961038961039,202003
佐野店,1544,1249,295,1146,398,1096,448,145,140,139,152,143,120,148,149,122,154,132,34.754203362690156,202003
保土ケ谷店,1306,1068,238,942,364,932,374,124,123,112,125,123,121,120,129,88,121,120,34.26310861423221,202003
入間店,1180,972,208,877,303,835,345,119,102,83,112,133,106,103,89,114,105,114,34.276748971193406,202003
八千代店,1276,1041,235,966,310,905,371,108,111,117,110,124,104,120,126,125,113,118,34.068203650336216,202003
八潮店,1247,1033,214,909,338,885,362,119,101,110,128,126,111,107,115,106,123,101,33.75121006776379,202003
八王子店,1568,1292,276,1146,422,1111,457,137,159,147,143,116,142,136,151,136,148,153,34.69736842105263,202003
六本木店,1032,827,205,742,290,734,298,91,93,79,96,83,88,91,101,102,99,109,35.220072551390565,202003
前橋店,848,682,166,641,207,600,248,85,77,85,76,75,69,71,85,62,83,80,33.7008797653959,202003
北千住店,1035,839,196,777,258,734,301,101,82,88,100,78,93,87,106,107,94,99,34.531585220500595,202003
千葉中央店,1305,1060,245,966,339,923,382,101,144,111,94,116,112,118,119,132,136,122,34.966981132075475,202003
千葉緑店,1191,957,234,874,317,846,345,116,116,115,90,104,108,105,104,119,102,112,35.337513061650995,202003
南砂店,1301,1066,235,979,322,923,378,120,101,120,132,113,109,120,129,122,130,105,35.117260787992485,202003
南足柄店,1025,823,202,744,281,723,302,92,96,102,91,84,91,93,86,81,107,102,33.46172539489672,202003
厚木店,1494,1216,278,1099,395,1059,435,135,124,139,139,140,146,152,129,136,132,122,34.88240131578947,202003
取手店,1184,957,227,866,318,838,346,107,101,102,117,110,102,107,109,116,103,110,34.79937304075236,202003
向島店,1066,864,202,776,290,759,307,99,114,98,83,99,89,90,115,85,101,93,35.13194444444444,202003
君津店,1123,903,220,843,280,796,327,111,87,99,111,88,105,95,115,120,106,86,35.331118493909194,202003
和光店,1336,1090,246,965,371,952,384,125,140,124,125,130,106,117,120,120,107,122,34.3,202003
品川店,1497,1187,310,1103,394,1061,436,160,138,143,124,146,138,127,110,145,119,147,34.39090143218197,202003
四街道店,851,701,150,599,252,603,248,78,82,67,68,77,81,78,86,75,86,73,34.87018544935806,202003
国分寺店,1008,815,193,740,268,716,292,94,97,108,83,87,86,86,88,84,111,84,34.988957055214726,202003
国立店,1397,1139,258,1021,376,987,410,141,122,122,114,129,123,132,129,126,116,143,34.05355575065848,202003
坂戸店,1184,964,220,878,306,842,342,98,112,113,121,89,118,108,109,89,112,115,34.102697095435694,202003
墨田店,1002,805,197,717,285,709,293,77,86,85,88,95,92,82,94,92,117,94,34.29565217391304,202003
多摩店,1094,884,210,782,312,778,316,97,101,94,86,86,104,116,104,97,110,99,35.09389140271493,202003
大久保店,1060,858,202,785,275,749,311,86,101,94,76,96,109,102,103,93,99,101,35.087412587412594,202003
大井店,1213,998,215,914,299,862,351,105,113,99,123,96,108,112,123,123,108,103,34.33567134268537,202003
大和店,1367,1134,233,1007,360,972,395,124,142,105,114,132,132,101,129,126,135,127,34.38977072310406,202003
大塚店,1120,888,232,819,301,793,327,93,107,113,95,95,118,104,95,85,102,113,34.0518018018018,202003
大宮店,1361,1109,252,1033,328,963,398,126,114,125,140,122,121,118,126,132,104,133,34.443642921550946,202003
大森店,1429,1164,265,1038,391,1012,417,137,122,133,106,142,118,135,135,126,147,128,34.79725085910653,202003
大泉店,1219,978,241,895,324,862,357,106,111,133,112,111,88,108,106,113,120,111,34.81697341513292,202003
大田店,945,798,147,730,215,670,275,91,85,82,81,87,88,95,78,82,85,91,34.60025062656641,202003
太田店,1368,1123,245,992,376,971,397,144,129,110,121,137,119,146,119,113,117,113,34.8833481745325,202003
宇都宮店,1095,909,186,814,281,775,320,100,102,102,82,107,90,99,101,108,109,95,34.617161716171616,202003
守谷店,1186,951,235,875,311,839,347,99,100,122,108,119,109,128,80,103,108,110,34.362776025236585,202003
宮前店,730,605,125,550,180,522,208,80,63,54,74,59,74,64,65,72,74,51,35.24628099173554,202003
富岡店,1094,881,213,785,309,778,316,97,94,105,92,100,100,93,97,105,103,108,33.36435868331441,202003
富津店,1037,862,175,762,275,735,302,116,73,108,73,104,92,101,95,93,94,88,34.435034802784216,202003
富里店,1492,1217,275,1109,383,1062,430,145,128,144,128,127,125,123,132,154,139,147,34.05341002465078,202003
小山店,1033,840,193,764,269,735,298,81,106,105,99,100,89,83,88,101,97,84,34.597619047619055,202003
小平店,1005,814,191,725,280,715,290,77,96,98,95,98,81,103,98,100,76,83,34.750614250614255,202003
小田原店,915,750,165,675,240,652,263,79,104,85,85,96,67,76,83,80,82,78,34.012,202003
小金井店,1096,899,197,832,264,779,317,115,108,97,88,99,94,110,93,94,104,94,34.080088987764185,202003
川口店,1118,914,204,811,307,791,327,118,105,115,94,86,96,100,103,98,118,85,34.171772428884026,202003
川崎多摩店,1116,910,206,799,317,794,322,100,105,116,106,102,97,90,105,98,99,98,34.862637362637365,202003
川崎店,1217,978,239,920,297,863,354,105,101,92,118,111,118,117,117,109,119,110,47.083844580777104,202003
川越店,1157,914,243,838,319,821,336,95,101,107,107,104,100,105,125,106,101,106,48.066739606126916,202003
巣鴨店,1512,1239,273,1143,369,1075,437,145,113,109,135,146,162,140,137,142,140,143,34.826472962066184,202003
市原店,1193,982,211,890,303,848,345,100,102,89,121,104,106,111,129,104,115,112,34.89409368635438,202003
市川店,1183,966,217,856,327,838,345,104,94,103,108,98,128,116,126,109,105,92,48.34575569358178,202003
平塚店,1187,971,216,912,275,842,345,110,97,120,111,111,102,98,124,111,118,85,34.055612770339856,202003
幸店,1431,1155,276,1063,368,1014,417,155,122,142,123,143,105,141,113,129,129,129,34.304761904761904,202003
府中店,1250,1022,228,941,309,885,365,119,108,122,105,119,124,104,108,106,121,114,34.611545988258314,202003
座間店,1372,1117,255,1007,365,976,396,119,128,141,137,123,144,118,113,119,125,105,35.70993733213965,202003
志木店,912,763,149,683,229,645,267,74,73,94,86,86,88,101,78,81,77,74,34.344692005242464,202003
恵比寿店,1031,840,191,769,262,730,301,99,85,94,102,97,78,93,105,95,94,89,20.321428571428573,202003
愛甲店,1065,874,191,769,296,754,311,80,92,101,104,81,87,94,118,87,103,118,33.86842105263157,202003
成城店,1377,1131,246,1008,369,978,399,131,127,125,128,138,138,114,131,114,121,110,34.0893015030946,202003
成田店,876,701,175,683,193,619,257,77,87,63,94,82,82,88,69,77,91,66,35.10841654778887,202003
我孫子店,1121,944,177,818,303,797,324,100,113,98,110,97,99,111,96,95,99,103,20.463983050847453,202003
戸塚店,1549,1272,277,1137,412,1098,451,149,142,139,148,133,129,144,145,125,141,154,34.79638364779874,202003
戸田店,1549,1264,285,1169,380,1099,450,141,134,143,137,133,142,149,142,146,130,152,34.36787974683544,202003
所沢店,1183,968,215,863,320,837,346,106,97,98,122,119,114,102,122,105,94,104,35.191115702479344,202003
新宿店,1093,895,198,840,253,775,318,126,99,103,101,99,89,80,100,104,97,95,34.154189944134075,202003
新座店,1032,836,196,771,261,733,299,91,78,96,81,105,88,95,109,87,108,94,35.28827751196173,202003
日本橋店,1462,1213,249,1096,366,1039,423,120,121,134,122,149,121,141,124,134,158,138,34.248969497114594,202003
日立店,1309,1077,232,959,350,929,380,139,127,126,114,121,106,110,112,137,123,94,34.13184772516249,202003
日野店,1157,924,233,838,319,822,335,90,102,89,101,104,101,113,102,130,99,126,34.01190476190476,202003
旭店,1256,1031,225,930,326,891,365,114,121,111,115,110,109,117,103,117,118,121,35.008729388942776,202003
春日部店,1183,967,216,875,308,840,343,115,105,100,121,107,114,102,109,96,113,101,34.377456049638056,202003
昭島店,1216,973,243,879,337,864,352,125,113,106,110,115,108,103,116,120,105,95,34.68756423432682,202003
木更津店,1118,908,210,824,294,794,324,95,100,111,93,102,90,95,111,121,97,103,34.756607929515425,202003
本庄店,1186,968,218,864,322,841,345,117,94,105,108,109,115,106,113,107,113,99,34.140495867768585,202003
本郷店,761,606,155,566,195,540,221,60,71,67,57,64,74,85,64,70,77,72,47.882838283828384,202003
杉並店,1247,979,268,910,337,890,357,124,115,112,117,113,124,112,97,105,127,101,34.586312563840664,202003
東中野店,1428,1197,231,1046,382,1013,415,123,115,127,114,123,153,128,137,137,136,135,34.00334168755221,202003
東久留米店,877,718,159,645,232,624,253,81,72,85,83,80,84,94,71,77,78,72,34.108635097493035,202003
東大和店,1094,906,188,823,271,775,319,109,102,108,85,107,83,96,84,103,104,113,34.18322295805739,202003
東尾久店,1211,1001,210,901,310,861,350,109,117,108,119,111,127,104,123,94,97,102,35.006993006993014,202003
東村山店,1065,893,172,773,292,757,308,93,96,89,99,87,93,114,102,97,97,98,33.076147816349376,202003
東松山店,1332,1105,227,1012,320,947,385,127,129,120,108,126,105,115,114,136,132,120,34.60361990950227,202003
松戸店,1247,1011,236,896,351,884,363,111,118,138,102,111,108,105,105,121,106,122,34.532146389713155,202003
板橋店,1095,887,208,798,297,775,320,100,89,101,94,121,108,82,88,113,103,96,47.60541149943629,202003
柏店,1517,1246,271,1140,377,1075,442,113,143,149,157,141,121,128,139,145,136,145,35.223113964686995,202003
栃木店,1095,882,213,813,282,776,319,107,94,111,100,100,100,93,98,105,99,88,34.20748299319728,202003
栄店,1575,1301,274,1145,430,1116,459,166,147,141,146,150,127,140,131,146,126,155,20.108378170637966,202003
桐生店,1256,1022,234,929,327,890,366,135,111,114,98,112,101,110,117,122,126,110,35.30528375733855,202003
横浜南店,1434,1166,268,1082,352,1017,417,137,131,118,146,141,117,121,129,141,128,125,33.80617495711835,202003
横浜緑店,1301,1051,250,972,329,923,378,138,111,103,117,105,129,126,114,121,128,109,34.595623215984766,202003
横須賀店,1087,898,189,808,279,770,317,100,104,89,93,95,108,90,116,98,101,93,34.650334075723826,202003
武蔵村山店,1304,1068,236,971,333,927,377,115,127,112,132,114,116,140,108,112,116,112,34.63857677902622,202003
武蔵野店,1091,873,218,811,280,775,316,93,100,98,93,96,104,85,108,83,111,120,33.79381443298969,202003
水戸店,1389,1120,269,1039,350,981,408,119,111,145,134,131,130,113,126,118,118,144,34.68928571428572,202003
江戸川店,1182,963,219,844,338,842,340,101,115,117,110,124,96,108,100,100,111,100,35.01453790238837,202003
江東店,1254,1024,230,920,334,891,363,124,119,124,116,131,104,119,116,92,86,123,34.255859375,202003
池尻店,1209,1002,207,888,321,855,354,99,117,105,97,121,117,111,108,124,112,98,35.233532934131745,202003
池袋店,1455,1186,269,1062,393,1030,425,123,143,125,159,150,136,98,138,125,131,127,34.411467116357514,202003
泉店,1492,1221,271,1092,400,1059,433,162,133,113,137,148,129,133,138,132,130,137,34.83456183456183,202003
流山店,1529,1228,301,1125,404,1085,444,123,163,130,143,139,140,123,144,137,154,133,33.8314332247557,202003
浅草店,1407,1153,254,1080,327,1000,407,129,111,125,111,127,145,142,139,130,124,124,34.13703382480486,202003
浦和店,1309,1068,241,967,342,931,378,138,119,121,123,120,104,121,119,119,116,109,34.098314606741575,202003
浦安店,1339,1091,248,1004,335,953,386,121,115,113,121,123,120,123,133,122,117,131,34.132905591200725,202003
海老名店,1187,959,228,864,323,839,348,136,100,114,105,104,108,116,110,94,87,113,35.06986444212722,202003
清瀬店,1065,872,193,804,261,757,308,97,102,81,113,97,79,95,108,93,104,96,35.060779816513765,202003
渋谷店,1150,942,208,862,288,814,336,103,111,96,121,104,109,109,97,107,95,98,34.073248407643305,202003
港北店,1036,853,183,767,269,736,300,90,93,82,100,108,89,87,97,104,97,89,21.141852286049236,202003
港南店,1247,1012,235,927,320,888,359,124,115,111,113,116,105,129,108,103,113,110,35.09683794466403,202003
瀬谷店,1449,1192,257,1085,364,1033,416,117,143,119,120,125,155,110,154,137,141,128,34.66778523489933,202003
熊谷店,1126,929,197,831,295,796,330,92,105,108,112,106,104,110,95,95,100,99,34.65554359526372,202003
狛江店,1250,1020,230,887,363,886,364,111,99,105,111,136,100,96,117,130,128,117,34.61862745098039,202003
狭山店,1428,1173,255,1050,378,1015,413,119,118,142,120,125,149,125,127,138,126,139,34.923273657289,202003
王子店,1161,960,201,877,284,825,336,99,110,95,99,109,128,98,104,102,114,103,20.404166666666665,202003
町田店,1338,1096,242,1026,312,947,391,131,120,122,113,116,106,125,138,125,128,114,34.818430656934304,202003
白井店,1103,869,234,804,299,783,320,93,97,109,112,101,101,91,104,93,102,100,49.423475258918295,202003
目黒店,1209,976,233,898,311,859,350,99,128,132,106,97,111,112,96,105,116,107,34.994877049180324,202003
相模原店,1491,1216,275,1097,394,1059,432,133,152,140,127,130,146,139,116,139,119,150,34.709703947368425,202003
石神井店,973,778,195,728,245,692,281,91,82,81,108,83,82,101,94,88,85,78,47.94215938303342,202003
磯子店,943,776,167,702,241,667,276,75,88,75,87,70,97,92,91,85,94,89,34.44458762886598,202003
神奈川店,1385,1125,260,1056,329,980,405,123,127,137,133,124,122,121,125,122,122,129,34.328,202003
神田店,1462,1207,255,1076,386,1036,426,153,125,119,139,123,135,136,134,126,136,136,34.43910521955261,202003
福生店,1370,1114,256,1007,363,972,398,116,125,118,117,113,112,132,133,124,138,142,34.82405745062837,202003
秦野店,1243,1011,232,939,304,882,361,106,108,123,111,118,134,112,96,119,115,101,34.881305637982194,202003
稲城店,972,794,178,734,238,691,281,92,84,85,91,105,79,85,93,94,82,82,46.70277078085642,202003
立川店,1311,1061,250,921,390,929,382,119,138,114,116,117,134,134,95,103,131,110,35.226201696512724,202003
綾瀬店,2702,2217,485,1971,731,1925,777,247,234,253,260,234,250,259,231,252,234,248,34.84122688317546,202003
練馬店,1426,1162,264,1074,352,1014,412,148,137,146,140,121,136,123,111,130,129,105,33.99397590361445,202003
羽村店,1396,1155,241,1008,388,989,407,133,117,128,105,135,122,134,136,134,125,127,20.53852813852814,202003
羽生店,1347,1104,243,994,353,957,390,125,139,103,123,116,140,108,138,106,127,122,35.73822463768116,202003
習志野店,1429,1198,231,1042,387,1012,417,140,123,143,155,110,121,106,139,145,126,121,33.95826377295492,202003
自由が丘店,1306,1056,250,976,330,925,381,120,102,114,121,136,114,107,121,117,120,134,33.74526515151515,202003
船橋店,1498,1224,274,1099,399,1065,433,162,137,119,134,129,136,137,134,134,158,118,34.20016339869281,202003
若葉店,1187,979,208,862,325,842,345,100,103,126,104,73,110,120,121,89,128,113,34.78038815117468,202003
茂原店,1359,1073,286,985,374,961,398,110,124,123,102,114,119,139,119,129,139,141,33.851817334575955,202003
茅ヶ崎店,904,749,155,661,243,645,259,91,70,82,79,84,69,84,75,89,90,91,35.34178905206942,202003
草加店,1001,833,168,747,254,707,294,98,97,87,94,97,84,84,90,102,74,94,34.24249699879952,202003
荒川店,914,734,180,688,226,649,265,81,75,76,85,76,97,83,97,84,89,71,34.76839237057221,202003
荻窪店,1242,1014,228,906,336,884,358,109,99,102,118,127,118,114,112,113,116,114,20.44871794871795,202003
葛飾店,1164,951,213,877,287,826,338,127,114,107,96,87,103,118,103,95,98,116,34.235541535226076,202003
蒲田店,1035,859,176,791,244,735,300,92,109,102,94,81,91,85,114,99,89,79,34.976717112922,202003
藤沢店,1185,959,226,855,330,839,346,116,105,124,101,90,105,99,107,116,113,109,34.63190823774765,202003
行田店,1002,818,184,734,268,713,289,90,96,96,88,96,90,82,90,100,78,96,34.728606356968214,202003
西多摩店,1591,1301,290,1165,426,1128,463,134,116,143,142,166,144,160,160,147,147,132,35.16295157571099,202003
西東京店,1004,833,171,725,279,712,292,93,102,90,90,93,95,79,85,91,94,92,34.06842737094838,202003
西葛西店,812,657,155,577,235,580,232,90,74,74,69,64,84,77,65,61,79,75,34.789954337899545,202003
調布店,1430,1170,260,1074,356,1019,411,140,128,148,132,119,123,125,118,141,133,123,34.12905982905983,202003
谷中店,1545,1255,290,1156,389,1099,446,139,132,143,152,124,138,142,162,147,122,144,34.177689243027885,202003
赤坂店,1027,851,176,773,254,726,301,91,98,79,106,98,96,71,102,87,91,108,34.86016451233843,202003
赤羽店,1182,950,232,861,321,842,340,115,121,109,87,114,117,99,106,104,94,116,46.358947368421056,202003
越谷店,904,712,192,643,261,641,263,78,84,76,84,79,87,69,94,86,94,73,46.62640449438202,202003
足利店,813,658,155,586,227,580,233,85,81,77,66,58,73,82,77,59,74,81,35.110942249240125,202003
足柄上店,1246,1012,234,954,292,881,365,102,106,126,122,105,112,129,111,112,102,119,34.1798418972332,202003
足立店,882,714,168,642,240,626,256,80,88,83,73,83,72,84,83,84,85,67,34.31932773109244,202003
逗子店,1099,889,210,848,251,781,318,105,104,93,84,110,106,109,104,91,94,99,34.922384701912264,202003
那珂店,1220,1007,213,912,308,864,356,132,91,123,104,116,111,105,91,116,98,133,19.96325719960278,202003
都筑店,1031,846,185,777,254,737,294,88,101,101,100,98,98,96,81,82,96,90,34.13475177304964,202003
金沢店,1279,1058,221,951,328,909,370,136,121,113,123,127,106,102,107,109,117,118,20.08601134215501,202003
銀座店,995,811,184,727,268,706,289,97,111,103,76,75,97,77,98,86,84,91,34.684340320591865,202003
鎌倉店,1006,841,165,730,276,718,288,83,89,101,93,92,103,83,98,98,91,75,33.74791914387634,202003
青山店,1364,1120,244,1009,355,968,396,137,133,130,104,125,138,105,117,125,116,134,34.66875,202003
青梅店,1281,1042,239,1009,272,909,372,117,114,118,106,112,112,125,122,128,112,115,33.98752399232246,202003
青葉店,1150,950,200,864,286,817,333,120,108,104,98,109,92,106,110,122,99,82,35.09789473684211,202003
館林店,1188,949,239,875,313,844,344,99,121,99,140,109,91,115,110,104,105,95,34.65964172813488,202003
駒沢店,1038,857,181,763,275,736,302,88,94,101,93,110,93,93,77,104,98,87,34.43757292882147,202003
駒込店,1482,1190,292,1097,385,1057,425,122,139,134,130,133,153,136,138,149,125,123,34.259663865546216,202003
高円寺店,1431,1147,284,1058,373,1018,413,122,125,116,143,156,106,158,120,118,130,137,35.666957279860505,202003
高島平店,1253,1014,239,945,308,890,363,113,131,117,114,119,103,127,98,95,109,127,34.63609467455621,202003
高崎店,1149,955,194,832,317,817,332,115,89,111,90,137,110,85,119,89,94,110,34.790575916230374,202003
高座店,1152,941,211,851,301,815,337,92,93,100,88,119,106,124,121,109,99,101,34.159404888416574,202003
高津店,1155,935,220,864,291,821,334,95,120,107,113,103,108,102,91,104,116,96,34.38502673796791,202003
高田馬場店,1093,857,236,791,302,777,316,91,115,114,103,87,100,99,93,97,85,109,34.97899649941657,202003
鴻巣店,1153,951,202,863,290,821,332,105,107,111,119,89,108,99,106,107,101,101,34.634069400630906,202003
鶴見店,1514,1236,278,1093,421,1071,443,144,138,118,137,161,152,130,136,138,129,131,34.81715210355987,202003
麻生店,1397,1145,252,1050,347,994,403,121,115,122,120,113,139,129,117,144,141,136,34.38340611353712,202003
あきる野店,1147,945,202,848,299,842,305,92,125,112,101,97,105,103,97,110,109,96,34.520634920634926,202004
さいたま南店,1500,1222,278,1128,372,1101,399,134,135,140,142,143,138,127,115,142,131,153,34.225859247135844,202004
さいたま緑店,1021,850,171,751,270,745,276,91,90,108,94,102,83,90,90,92,96,85,35.114117647058826,202004
さいたま西店,1170,942,228,857,313,858,312,120,98,109,113,103,109,104,111,96,109,98,34.54246284501062,202004
つくば店,1265,1028,237,962,303,930,335,120,119,104,103,125,121,110,108,101,130,124,34.68579766536965,202004
三浦店,1153,958,195,871,282,845,308,113,102,86,111,108,129,102,101,103,100,98,34.791231732776616,202004
三鷹店,1505,1217,288,1110,395,1103,402,140,111,134,144,153,135,143,138,126,148,133,34.653245686113394,202004
上尾店,1324,1099,225,963,361,971,353,126,128,120,105,121,117,114,126,116,117,134,20.045495905368515,202004
上野店,1609,1280,329,1196,413,1184,425,139,148,152,127,140,158,136,151,163,163,132,35.0875,202004
世田谷店,1537,1236,301,1134,403,1126,411,150,141,144,128,147,147,120,117,157,133,153,34.60679611650485,202004
中原店,1529,1262,267,1152,377,1123,406,143,126,139,134,144,142,136,136,147,153,129,34.454833597464344,202004
中店,1207,989,218,917,290,881,326,82,147,85,117,115,106,142,102,111,85,115,34.92922143579373,202004
中野店,1142,918,224,830,312,840,302,102,107,99,123,97,101,99,104,107,106,97,35.514161220043576,202004
久喜店,1302,1045,257,941,361,956,346,111,111,135,122,124,105,113,105,136,121,119,34.020095693779915,202004
九段店,1325,1080,245,993,332,971,354,122,108,109,133,121,98,135,122,129,134,114,34.30833333333333,202004
亀有店,1035,852,183,777,258,760,275,86,100,99,97,97,118,74,73,109,91,91,35.51056338028169,202004
五反田店,1146,934,212,851,295,840,306,100,100,123,91,116,107,94,103,89,107,116,34.29443254817987,202004
代々木店,1351,1077,274,992,359,988,363,124,118,130,122,130,126,135,120,110,117,119,34.773444753946144,202004
伊勢原店,1445,1171,274,1058,387,1058,387,145,140,127,123,131,116,133,120,129,150,131,34.51921434671221,202004
伊勢崎店,1581,1292,289,1175,406,1160,421,144,142,151,142,146,136,143,136,156,138,147,35.04102167182663,202004
佐倉店,879,722,157,654,225,644,235,86,73,70,92,100,72,89,68,76,74,79,34.61357340720222,202004
佐野店,1490,1220,270,1096,394,1093,397,138,131,139,140,137,128,132,135,135,138,137,34.52131147540984,202004
保土ケ谷店,1255,1044,211,947,308,924,331,119,112,101,122,101,127,129,100,110,116,118,35.18007662835249,202004
入間店,1143,931,212,873,270,835,308,107,110,92,95,117,112,109,109,97,95,100,33.27175080558539,202004
八千代店,1233,1017,216,889,344,905,328,115,119,113,106,92,123,113,123,120,96,113,34.720747295968536,202004
八潮店,1214,988,226,876,338,888,326,119,128,96,108,107,97,116,101,115,114,113,34.7753036437247,202004
八王子店,1524,1237,287,1095,429,1121,403,142,152,138,126,138,135,135,146,138,128,146,34.48504446240906,202004
六本木店,998,796,202,741,257,731,267,86,91,101,92,90,83,91,92,98,89,85,35.00628140703517,202004
前橋店,821,679,142,598,223,599,222,57,86,59,72,83,75,91,73,74,73,78,34.00294550810015,202004
北千住店,993,822,171,726,267,727,266,88,84,86,96,92,89,84,107,95,77,95,33.90632603406326,202004
千葉中央店,1268,1030,238,947,321,929,339,109,119,120,105,107,101,131,118,109,118,131,34.512621359223296,202004
千葉緑店,1149,926,223,848,301,843,306,120,94,90,80,113,111,89,115,102,117,118,34.734341252699785,202004
南砂店,1263,1057,206,943,320,924,339,118,120,111,96,132,122,96,113,110,124,121,34.570482497634806,202004
南足柄店,1001,830,171,755,246,734,267,85,87,100,85,97,84,85,92,80,106,100,33.616867469879516,202004
厚木店,1435,1153,282,1032,403,1053,382,134,129,127,123,129,117,149,136,134,125,132,34.70945359930616,202004
取手店,1149,956,193,853,296,842,307,86,107,101,103,109,108,89,109,103,121,113,33.81694560669456,202004
向島店,1023,848,175,756,267,752,271,106,93,103,94,86,98,100,75,98,84,86,34.1002358490566,202004
君津店,1088,914,174,785,303,799,289,77,88,110,95,96,105,100,85,95,119,118,34.78993435448579,202004
和光店,1294,1059,235,977,317,950,344,114,128,110,118,105,118,121,147,116,92,125,34.82719546742209,202004
品川店,1438,1181,257,1044,394,1056,382,124,121,131,126,136,122,141,137,131,135,134,34.8458933107536,202004
四街道店,816,662,154,621,195,601,215,74,87,82,69,76,71,66,72,65,75,79,34.96676737160121,202004
国分寺店,969,795,174,725,244,712,257,74,73,91,90,98,104,100,80,87,86,86,34.92075471698113,202004
国立店,1347,1093,254,987,360,991,356,136,113,120,124,117,130,114,114,109,146,124,33.93412625800549,202004
坂戸店,1146,926,220,891,255,842,304,95,117,98,92,102,108,118,110,122,99,85,34.38012958963282,202004
墨田店,970,784,186,713,257,710,260,85,97,93,77,82,89,86,83,91,102,85,35.25382653061224,202004
多摩店,1067,879,188,769,298,783,284,90,99,98,107,99,95,94,94,86,101,104,34.805460750853236,202004
大久保店,1021,846,175,754,267,748,273,92,104,100,89,85,99,95,97,86,93,81,35.219858156028366,202004
大井店,1177,950,227,870,307,861,316,100,100,118,108,122,102,104,110,115,99,99,34.35052631578947,202004
大和店,1325,1059,266,978,347,973,352,123,109,121,115,114,127,121,115,111,148,121,33.881964117091606,202004
大塚店,1091,902,189,807,284,799,292,115,98,87,94,109,97,106,101,84,101,99,35.44456762749446,202004
大宮店,1329,1080,249,969,360,975,354,125,138,117,126,128,119,95,119,117,125,120,34.486111111111114,202004
大森店,1383,1113,270,1021,362,1015,368,119,106,127,120,151,144,132,133,102,121,128,34.23809523809524,202004
大泉店,1174,935,239,875,299,860,314,114,109,106,113,103,114,107,99,88,113,108,34.50374331550802,202004
大田店,917,727,190,692,225,674,243,72,76,98,83,71,78,92,90,91,87,79,33.463548830811554,202004
太田店,1328,1059,269,958,370,971,357,102,114,107,132,131,125,134,103,126,123,131,34.0028328611898,202004
宇都宮店,1055,865,190,773,282,771,284,98,100,86,88,93,106,89,96,98,96,105,33.96763005780347,202004
守谷店,1149,947,202,875,274,842,307,117,103,114,99,92,95,107,98,98,108,118,34.278775079197466,202004
宮前店,702,567,135,520,182,512,190,69,60,64,61,65,54,61,72,67,61,68,35.0,202004
富岡店,1068,881,187,800,268,784,284,104,114,102,120,86,82,112,96,74,74,104,35.603859250851315,202004
富津店,1006,820,186,749,257,738,268,95,85,88,94,111,81,103,81,88,104,76,33.72439024390244,202004
富里店,1439,1158,281,1067,372,1054,385,118,135,117,144,142,126,159,143,131,115,109,34.325561312607945,202004
小山店,1004,793,211,742,262,739,265,82,107,93,100,71,83,91,90,95,100,92,34.84741488020177,202004
小平店,968,802,166,714,254,709,259,81,81,100,98,90,86,90,97,80,87,78,33.50748129675811,202004
小田原店,884,709,175,648,236,647,237,81,89,91,87,73,76,76,80,76,65,90,33.744710860366716,202004
小金井店,1058,858,200,779,279,778,280,92,96,79,95,97,95,102,91,111,99,101,33.963869463869464,202004
川口店,1081,899,182,789,292,791,290,94,111,104,97,85,96,95,98,104,84,113,34.30589543937709,202004
川崎多摩店,1095,916,179,804,291,803,292,92,105,96,115,110,98,106,93,105,88,87,33.86353711790393,202004
川崎店,1182,949,233,880,302,868,314,108,105,100,116,92,121,95,123,109,100,113,46.7017913593256,202004
川越店,1120,913,207,855,265,820,300,113,99,107,103,107,95,80,107,95,98,116,48.16429353778752,202004
巣鴨店,1467,1199,268,1080,387,1075,392,172,138,133,108,116,149,136,144,123,121,127,34.403669724770644,202004
市原店,1148,941,207,837,311,844,304,110,105,101,104,115,117,94,120,97,102,83,34.258235919234856,202004
市川店,1151,912,239,839,312,842,309,98,117,105,112,110,119,101,90,95,98,106,47.76644736842106,202004
平塚店,1147,939,208,857,290,845,302,108,115,91,105,107,94,103,105,100,129,90,34.01597444089457,202004
幸店,1379,1120,259,1029,350,1006,373,134,132,114,134,121,104,103,125,146,125,141,34.20982142857143,202004
府中店,1198,976,222,890,308,883,315,110,102,120,108,112,109,94,104,113,110,116,35.02766393442623,202004
座間店,1325,1063,262,1004,321,969,356,131,136,111,113,122,121,129,115,129,110,108,34.77328316086548,202004
志木店,885,720,165,635,250,652,233,74,82,92,86,80,74,81,67,94,76,79,34.73888888888889,202004
恵比寿店,990,818,172,761,229,725,265,81,77,95,88,79,84,89,97,95,96,109,20.255501222493887,202004
愛甲店,1032,850,182,755,277,755,277,98,87,86,88,102,109,83,91,88,95,105,34.55529411764706,202004
成城店,1319,1092,227,996,323,967,352,114,124,106,127,118,131,117,114,130,129,109,34.88186813186813,202004
成田店,854,716,138,636,218,630,224,71,73,70,85,82,65,105,64,84,94,61,34.733240223463696,202004
我孫子店,1087,901,186,825,262,797,290,104,79,87,97,105,104,106,108,107,92,98,19.681465038845726,202004
戸塚店,1499,1227,272,1088,411,1100,399,141,143,151,124,114,142,166,126,132,128,132,34.303178484107576,202004
戸田店,1501,1185,316,1120,381,1099,402,121,124,138,132,126,145,138,151,145,148,133,35.32995780590717,202004
所沢店,1144,933,211,834,310,840,304,96,103,111,85,103,115,123,90,106,114,98,33.9978563772776,202004
新宿店,1067,881,186,772,295,782,285,96,100,91,100,98,79,111,110,95,94,93,34.41884222474461,202004
新座店,997,801,196,761,236,734,263,89,82,77,99,91,111,85,95,77,95,96,34.96004993757803,202004
日本橋店,1403,1169,234,1037,366,1030,373,131,135,121,106,148,126,119,136,134,133,114,34.60479041916168,202004
日立店,1259,1026,233,930,329,922,337,126,115,109,113,115,128,126,96,89,126,116,34.634502923976605,202004
日野店,1116,926,190,838,278,816,300,113,95,93,92,88,105,113,110,108,91,108,34.42548596112311,202004
旭店,1206,973,233,889,317,886,320,113,112,110,119,94,120,109,109,118,93,109,34.068859198355604,202004
春日部店,1140,934,206,836,304,833,307,105,105,123,99,95,102,116,99,109,100,87,33.97002141327623,202004
昭島店,1166,946,220,867,299,860,306,108,106,123,103,100,99,98,122,95,115,97,34.59830866807611,202004
木更津店,1094,888,206,810,284,801,293,101,95,99,83,113,95,114,100,98,112,84,34.03378378378378,202004
本庄店,1154,932,222,846,308,849,305,131,81,115,81,96,122,117,98,124,94,95,34.7049356223176,202004
本郷店,735,593,142,551,184,540,195,62,62,66,67,63,68,64,63,64,80,76,48.41315345699832,202004
杉並店,1211,993,218,910,301,888,323,120,96,97,116,108,103,116,119,102,121,113,34.77240684793555,202004
東中野店,1385,1125,260,1033,352,1017,368,116,122,125,136,115,150,122,128,124,139,108,33.984,202004
東久留米店,854,709,145,623,231,626,228,68,84,76,80,84,88,64,88,60,72,90,34.66008462623413,202004
東大和店,1055,861,194,774,281,777,278,93,94,93,98,99,91,92,99,104,93,99,35.37282229965157,202004
東尾久店,1180,953,227,845,335,867,313,110,104,93,121,105,100,102,110,110,113,112,35.065057712486876,202004
東村山店,1027,827,200,772,255,753,274,85,92,99,91,102,85,106,79,98,86,104,35.27206771463121,202004
東松山店,1290,1060,230,968,322,947,343,128,123,132,104,111,114,112,105,135,120,106,35.45943396226415,202004
松戸店,1213,1005,208,894,319,889,324,113,140,98,107,109,124,104,98,97,112,111,34.701492537313435,202004
板橋店,1057,830,227,764,293,777,280,98,92,92,88,98,94,95,106,91,88,115,47.792771084337346,202004
柏店,1464,1200,264,1072,392,1079,385,147,138,134,128,118,122,137,135,121,149,135,34.44416666666667,202004
栃木店,1054,860,194,820,234,774,280,75,104,90,94,102,104,85,102,95,101,102,34.402325581395345,202004
栄店,1534,1279,255,1110,424,1128,406,130,151,127,152,143,140,147,136,141,128,139,20.292415949960915,202004
桐生店,1205,976,229,866,339,883,322,121,104,102,110,112,101,131,117,109,93,105,34.39139344262295,202004
横浜南店,1379,1144,235,1042,337,1011,368,116,118,128,128,114,129,122,143,125,120,136,33.68444055944056,202004
横浜緑店,1281,1032,249,921,360,941,340,113,93,118,95,116,114,121,135,125,140,111,34.79457364341085,202004
横須賀店,1061,868,193,783,278,778,283,96,92,96,104,88,91,118,92,85,99,100,35.134792626728114,202004
武蔵村山店,1268,1027,241,944,324,930,338,90,123,122,127,108,124,112,122,119,100,121,33.94449853943525,202004
武蔵野店,1056,869,187,784,272,773,283,90,80,97,102,87,93,113,103,99,93,99,33.777905638665125,202004
水戸店,1349,1089,260,1026,323,991,358,140,105,115,120,121,108,112,143,140,132,113,34.41138659320477,202004
江戸川店,1147,950,197,848,299,841,306,113,119,103,99,80,103,103,104,108,94,121,34.00631578947368,202004
江東店,1208,993,215,896,312,886,322,84,107,126,119,108,130,92,115,110,109,108,33.78751258811682,202004
池尻店,1172,959,213,850,322,858,314,114,99,109,117,130,103,100,106,100,86,108,34.43899895724713,202004
池袋店,1415,1176,239,1024,391,1039,376,134,122,132,113,132,147,126,125,135,124,125,34.865646258503396,202004
泉店,1443,1202,241,1072,371,1056,387,127,126,118,147,156,103,131,134,125,142,134,34.296173044925126,202004
流山店,1473,1208,265,1105,368,1081,392,153,120,137,141,143,143,106,133,149,126,122,34.68956953642384,202004
浅草店,1343,1094,249,999,344,989,354,145,121,115,119,115,118,133,132,115,115,115,34.92687385740402,202004
浦和店,1253,1031,222,930,323,919,334,101,119,106,101,131,116,94,132,137,105,111,35.35596508244422,202004
浦安店,1289,1048,241,945,344,943,346,102,99,117,108,125,110,121,138,115,127,127,34.76145038167939,202004
海老名店,1145,941,204,851,294,841,304,109,110,107,107,106,103,100,114,92,97,100,33.596174282678,202004
清瀬店,1025,819,206,742,283,751,274,94,94,100,70,95,98,91,95,100,92,96,35.42490842490842,202004
渋谷店,1121,928,193,827,294,823,298,100,97,97,98,101,84,113,132,100,94,105,34.66918103448276,202004
港北店,1006,858,148,739,267,736,270,92,83,90,94,100,95,114,83,91,85,79,20.186480186480182,202004
港南店,1198,991,207,869,329,873,325,106,108,112,99,94,112,87,127,116,113,124,34.74066599394551,202004
瀬谷店,1407,1153,254,1086,321,1031,376,132,107,117,112,142,135,141,135,132,125,129,34.194275802254985,202004
熊谷店,1090,884,206,831,259,796,294,100,89,94,94,122,104,111,101,85,100,90,33.52828054298642,202004
狛江店,1204,987,217,896,308,880,324,99,119,113,114,115,122,104,105,108,103,102,35.31509625126646,202004
狭山店,1377,1105,272,1024,353,1015,362,123,108,119,127,116,133,126,125,132,134,134,35.319457013574656,202004
王子店,1114,927,187,799,315,820,294,109,104,86,94,93,114,105,81,108,118,102,20.72491909385113,202004
町田店,1295,1072,223,961,334,947,348,123,112,109,125,117,134,113,105,129,109,119,34.160447761194035,202004
白井店,1061,850,211,764,297,779,282,101,106,102,78,99,96,88,105,109,98,79,47.45411764705882,202004
目黒店,1181,975,206,882,299,872,309,92,107,111,116,119,114,100,114,116,97,95,34.58871794871795,202004
相模原店,1434,1168,266,1051,383,1051,383,118,124,139,138,147,111,128,116,129,124,160,34.78938356164384,202004
石神井店,941,748,193,709,232,690,251,70,90,81,84,85,80,81,108,82,97,83,47.54545454545455,202004
磯子店,915,760,155,680,235,668,247,86,86,88,81,88,95,72,86,73,86,74,34.872368421052634,202004
神奈川店,1361,1092,269,1011,350,999,362,126,121,137,122,136,109,135,124,111,128,112,33.900183150183146,202004
神田店,1402,1156,246,1062,340,1033,369,148,125,107,123,140,125,128,122,124,128,132,34.78806228373703,202004
福生店,1317,1068,249,973,344,965,352,138,114,118,112,113,121,108,127,123,110,133,34.747191011235955,202004
秦野店,1204,995,209,869,335,883,321,110,106,104,119,99,115,115,102,128,106,100,34.29246231155779,202004
稲城店,938,747,191,690,248,691,247,62,82,101,77,95,78,86,91,89,88,89,48.87817938420347,202004
立川店,1261,1026,235,948,313,927,334,115,130,138,104,121,95,118,94,130,113,103,34.53508771929825,202004
綾瀬店,2607,2094,513,1896,711,1916,691,223,244,239,240,224,270,215,232,229,249,242,34.578796561604584,202004
練馬店,1376,1125,251,1039,337,1012,364,110,121,127,105,112,119,142,151,124,122,143,34.64355555555556,202004
羽村店,1358,1114,244,1020,338,999,359,125,114,120,132,132,115,122,130,131,115,122,20.19479353680431,202004
羽生店,1282,1039,243,947,335,942,340,129,106,127,114,95,137,119,118,126,98,113,34.7218479307026,202004
習志野店,1390,1127,263,1017,373,1019,371,134,115,137,126,140,130,125,110,144,112,117,34.31055900621118,202004
自由が丘店,1271,1053,218,936,335,932,339,125,121,116,104,124,120,114,105,105,131,106,34.44729344729345,202004
船橋店,1435,1164,271,1053,382,1056,379,117,117,146,146,126,127,139,132,135,135,115,34.903780068728516,202004
若葉店,1150,956,194,849,301,845,305,97,102,101,130,114,96,99,96,106,96,113,34.621338912133886,202004
茂原店,1332,1093,239,991,341,976,356,88,123,125,133,113,131,120,134,129,107,129,33.599268069533395,202004
茅ヶ崎店,886,722,164,650,236,648,238,86,84,77,85,96,58,93,78,86,69,74,34.980609418282555,202004
草加店,978,804,174,712,266,718,260,95,110,72,97,86,86,112,82,85,77,76,34.832089552238806,202004
荒川店,879,723,156,663,216,644,235,73,86,75,83,93,76,86,86,69,72,80,34.57399723374827,202004
荻窪店,1202,993,209,890,312,881,321,114,101,134,102,114,111,109,104,101,102,110,19.876132930513595,202004
葛飾店,1118,898,220,839,279,819,299,95,76,110,104,116,122,104,108,79,106,98,34.456570155902014,202004
蒲田店,1002,801,201,754,248,735,267,100,98,88,88,89,76,98,102,84,82,97,35.38451935081149,202004
藤沢店,1147,943,204,848,299,843,304,107,117,90,98,114,132,101,104,117,84,83,34.580063626723216,202004
行田店,973,780,193,740,233,713,260,79,98,80,96,103,83,69,89,93,98,85,35.437179487179485,202004
西多摩店,1534,1245,289,1136,398,1125,409,140,131,159,164,112,135,131,143,137,124,158,34.74618473895582,202004
西東京店,968,796,172,721,247,712,256,87,84,86,109,79,78,93,83,86,97,86,34.78517587939699,202004
西葛西店,792,659,133,608,184,581,211,64,81,70,69,76,75,69,88,70,63,67,34.537177541729896,202004
調布店,1382,1136,246,1014,368,1011,371,113,121,120,102,152,138,142,119,136,124,115,34.92517605633803,202004
谷中店,1503,1221,282,1123,380,1099,404,125,140,154,132,156,149,139,148,139,114,107,33.844389844389845,202004
赤坂店,1001,822,179,743,258,737,264,95,83,95,98,81,100,78,77,101,96,97,34.62895377128954,202004
赤羽店,1144,911,233,827,317,842,302,113,97,113,126,104,108,87,82,110,110,94,47.095499451152584,202004
越谷店,885,735,150,662,223,647,238,82,84,79,84,92,65,64,88,89,81,77,47.19047619047619,202004
足利店,795,670,125,604,191,582,213,71,66,74,76,59,78,71,85,68,80,67,34.97313432835821,202004
足柄上店,1208,984,224,887,321,885,323,113,102,129,106,112,115,122,93,100,107,109,33.91869918699187,202004
足立店,848,700,148,615,233,621,227,58,68,89,77,79,72,81,82,86,63,93,33.44714285714286,202004
逗子店,1055,862,193,772,283,773,282,110,84,83,105,100,102,90,97,98,91,95,34.53016241299304,202004
那珂店,1179,973,206,854,325,862,317,108,125,112,115,101,101,111,97,95,118,96,20.801644398766697,202004
都筑店,1009,821,188,762,247,740,269,81,115,89,99,65,81,104,95,99,86,95,34.76979293544458,202004
金沢店,1230,1024,206,912,318,903,327,103,116,107,113,89,116,127,125,117,102,115,20.1630859375,202004
銀座店,967,808,159,740,227,706,261,79,106,86,84,97,91,68,78,94,89,95,35.226485148514854,202004
鎌倉店,976,789,187,723,253,715,261,97,96,83,88,86,80,83,95,88,92,88,34.59062103929024,202004
青山店,1332,1079,253,964,368,976,356,127,90,120,120,144,124,134,117,118,132,106,35.084337349397586,202004
青梅店,1240,1003,237,901,339,909,331,116,93,94,124,113,106,134,124,99,123,114,35.24426719840478,202004
青葉店,1115,915,200,851,264,821,294,107,104,87,93,99,129,105,97,88,102,104,34.51256830601093,202004
館林店,1143,923,220,836,307,839,304,117,100,115,89,107,98,102,99,95,112,109,34.46695557963164,202004
駒沢店,1001,832,169,738,263,736,265,78,101,77,95,86,103,95,95,101,85,85,34.716346153846146,202004
駒込店,1439,1169,270,1025,414,1055,384,133,136,126,140,131,133,133,108,131,137,131,33.86911890504705,202004
高円寺店,1381,1138,243,1037,344,1007,374,129,123,119,135,111,126,137,111,120,146,124,34.35676625659051,202004
高島平店,1201,971,230,889,312,879,322,140,108,102,93,113,105,112,98,99,107,124,34.90731204943357,202004
高崎店,1112,915,197,806,306,813,299,105,109,104,94,116,103,106,99,90,94,92,34.5311475409836,202004
高座店,1109,909,200,819,290,810,299,105,98,95,116,76,105,90,117,97,110,100,33.87128712871287,202004
高津店,1115,921,194,814,301,821,294,101,104,87,109,114,94,100,99,105,111,91,34.25732899022801,202004
高田馬場店,1065,876,189,772,293,785,280,95,85,81,91,90,103,107,113,106,93,101,35.038812785388124,202004
鴻巣店,1114,900,214,838,276,818,296,107,89,113,100,109,98,96,102,99,107,94,35.178888888888885,202004
鶴見店,1479,1196,283,1080,399,1084,395,125,146,124,137,133,147,122,124,136,148,137,34.486622073578594,202004
麻生店,1346,1109,237,1017,329,986,360,112,125,124,124,123,99,120,118,123,134,144,34.07484220018034,202004
あきる野店,1184,959,225,882,302,801,383,114,99,112,120,104,100,109,96,107,104,119,34.566214807090724,202005
さいたま南店,1543,1249,294,1162,381,1046,497,120,143,159,137,151,140,156,123,153,138,123,34.07125700560449,202005
さいたま緑店,1061,842,219,776,285,719,342,97,86,93,96,109,102,88,102,87,99,102,34.09976247030879,202005
さいたま西店,1225,1032,193,900,325,830,395,103,102,102,113,102,136,109,115,106,122,115,34.44864341085271,202005
つくば店,1312,1057,255,963,349,889,423,113,133,130,119,130,100,123,124,102,110,128,34.906338694418174,202005
三浦店,1177,953,224,883,294,796,381,118,118,103,108,108,108,87,97,105,118,107,33.78174186778594,202005
三鷹店,1554,1261,293,1156,398,1058,496,164,122,136,140,140,131,138,154,137,153,139,34.73037272006344,202005
上尾店,1366,1104,262,1007,359,928,438,115,117,127,133,135,120,120,148,104,123,124,20.20289855072464,202005
上野店,1670,1378,292,1204,466,1133,537,172,147,150,151,140,157,142,144,182,119,166,35.0856313497823,202005
世田谷店,1584,1293,291,1175,409,1076,508,120,153,126,156,153,134,149,141,156,139,157,34.44083526682134,202005
中原店,1586,1275,311,1199,387,1075,511,152,153,133,152,130,154,135,145,139,139,154,34.44941176470589,202005
中店,1250,1036,214,950,300,845,405,136,99,119,116,102,117,105,111,119,127,99,34.22779922779923,202005
中野店,1188,980,208,872,316,805,383,131,104,130,106,108,101,102,99,96,108,103,35.234693877551024,202005
久喜店,1333,1080,253,979,354,902,431,122,146,129,116,122,123,118,125,101,115,116,35.266666666666666,202005
九段店,1362,1113,249,1004,358,918,444,119,142,128,117,121,120,132,122,122,114,125,35.1581311769991,202005
亀有店,1054,833,221,772,282,714,340,88,90,104,97,78,103,98,108,88,105,95,34.70348139255702,202005
五反田店,1184,975,209,850,334,798,386,99,128,106,96,108,99,101,119,126,107,95,34.723076923076924,202005
代々木店,1397,1133,264,1017,380,942,455,135,123,115,142,114,122,130,127,125,113,151,34.53221535745808,202005
伊勢原店,1490,1225,265,1101,389,1008,482,141,123,119,134,142,126,130,146,169,118,142,34.479183673469386,202005
伊勢崎店,1647,1351,296,1215,432,1114,533,155,176,153,158,149,165,137,130,146,135,143,34.56180606957809,202005
佐倉店,914,743,171,703,211,621,293,81,97,82,81,88,84,76,89,80,86,70,35.430686406460296,202005
佐野店,1552,1253,299,1139,413,1050,502,130,141,151,148,130,132,141,149,145,149,136,34.75498802873105,202005
保土ケ谷店,1307,1064,243,954,353,885,422,108,116,120,121,101,140,130,129,104,119,119,33.881578947368425,202005
入間店,1186,955,231,880,306,805,381,116,98,102,118,116,108,117,104,105,101,101,34.234554973821986,202005
八千代店,1279,1036,243,957,322,865,414,116,107,94,135,114,114,126,131,109,107,126,34.04150579150579,202005
八潮店,1245,1013,232,911,334,844,401,117,109,103,114,113,118,114,119,129,105,104,34.517275419545896,202005
八王子店,1582,1289,293,1187,395,1069,513,139,138,143,134,157,149,138,152,143,148,141,33.570985259891394,202005
六本木店,1033,854,179,738,295,705,328,81,98,95,100,103,99,86,97,88,79,107,34.92740046838407,202005
前橋店,847,681,166,612,235,573,274,67,61,88,81,82,66,77,67,87,84,87,33.928046989721,202005
北千住店,1029,834,195,774,255,698,331,95,99,90,72,86,107,101,107,93,74,105,34.54796163069545,202005
千葉中央店,1305,1078,227,951,354,883,422,106,124,116,133,96,133,115,121,103,125,133,34.316326530612244,202005
千葉緑店,1185,976,209,840,345,806,379,98,115,115,106,107,114,104,115,97,119,95,34.50409836065574,202005
南砂店,1302,1069,233,936,366,878,424,129,120,118,118,121,112,130,107,118,118,111,34.4798877455566,202005
南足柄店,1031,851,180,773,258,703,328,86,106,93,93,93,109,86,103,93,79,90,34.62514688601645,202005
厚木店,1491,1213,278,1108,383,1006,485,150,131,136,151,129,121,134,133,129,159,118,34.293487221764224,202005
取手店,1194,960,234,883,311,808,386,105,104,121,111,118,116,115,103,99,109,93,34.81666666666667,202005
向島店,1064,876,188,786,278,723,341,109,77,128,90,77,85,101,109,91,92,105,34.523972602739725,202005
君津店,1129,923,206,815,314,766,363,89,101,103,115,91,94,115,102,103,116,100,35.12892741061755,202005
和光店,1344,1115,229,989,355,914,430,127,121,130,120,102,114,133,112,130,118,137,34.42242152466368,202005
品川店,1487,1215,272,1080,407,1009,478,124,149,138,130,144,131,121,141,119,135,155,34.33251028806584,202005
四街道店,848,703,145,637,211,576,272,72,68,72,75,90,74,65,79,82,85,86,33.71123755334282,202005
国分寺店,1007,822,185,737,270,681,326,78,93,93,100,95,81,93,102,104,81,87,34.490267639902676,202005
国立店,1391,1145,246,1056,335,943,448,124,131,132,139,126,120,133,115,110,131,130,34.937991266375555,202005
坂戸店,1177,971,206,880,297,797,380,106,102,96,111,107,103,106,124,96,114,112,33.65602471678682,202005
墨田店,999,831,168,734,265,676,323,93,85,97,103,84,88,88,107,88,89,77,34.66546329723225,202005
多摩店,1090,887,203,829,261,737,353,94,97,106,99,87,99,107,109,107,96,89,34.17023675310034,202005
大久保店,1071,861,210,805,266,728,343,99,85,101,100,102,104,91,91,98,110,90,34.594657375145175,202005
大井店,1212,987,225,875,337,821,391,102,102,111,127,120,119,102,116,94,105,114,35.11651469098277,202005
大和店,1361,1099,262,1018,343,924,437,119,122,118,115,134,139,129,113,114,130,128,34.12374886260237,202005
大塚店,1128,923,205,840,288,763,365,102,92,102,107,91,94,108,113,107,94,118,33.37811484290358,202005
大宮店,1363,1145,218,1010,353,926,437,129,104,138,127,120,108,133,123,110,135,136,34.558078602620085,202005
大森店,1430,1181,249,1049,381,970,460,112,124,158,128,130,132,131,120,132,136,127,34.57493649449619,202005
大泉店,1222,1005,217,885,337,827,395,100,108,117,102,109,112,134,98,97,126,119,34.38009950248756,202005
大田店,946,763,183,709,237,641,305,94,76,99,84,80,76,81,86,95,83,92,34.74705111402359,202005
太田店,1365,1130,235,1021,344,929,436,133,121,144,122,118,114,110,127,118,124,134,34.541592920353985,202005
宇都宮店,1090,888,202,805,285,738,352,85,102,112,92,81,105,86,100,121,99,107,33.75225225225225,202005
守谷店,1190,1011,179,890,300,808,382,95,99,116,117,125,112,112,90,113,96,115,34.64985163204748,202005
宮前店,724,590,134,549,175,488,236,78,61,71,60,81,55,51,65,66,71,65,33.693220338983046,202005
富岡店,1098,868,230,819,279,744,354,102,111,92,110,68,101,109,93,107,96,109,34.88594470046083,202005
富津店,1039,860,179,785,254,706,333,102,89,100,84,115,85,102,75,91,101,95,33.62558139534884,202005
富里店,1490,1227,263,1153,337,1009,481,138,123,136,120,137,123,141,131,145,149,147,34.790546047269764,202005
小山店,1038,864,174,786,252,703,335,87,107,97,99,88,96,95,74,88,95,112,35.127314814814824,202005
小平店,1009,834,175,763,246,687,322,75,90,90,89,86,98,94,102,79,106,100,35.194244604316545,202005
小田原店,909,750,159,667,242,618,291,95,80,81,78,89,93,70,75,85,86,77,34.78533333333333,202005
小金井店,1097,889,208,804,293,741,356,98,114,87,95,107,99,97,107,96,101,96,34.161979752530925,202005
川口店,1131,924,207,826,305,764,367,101,105,97,108,110,106,110,79,116,97,102,34.709956709956714,202005
川崎多摩店,1124,907,217,837,287,761,363,101,119,95,91,106,91,93,98,115,102,113,34.42668136714443,202005
川崎店,1205,966,239,905,300,816,389,121,116,102,108,97,97,119,106,94,112,133,48.71739130434783,202005
川越店,1153,922,231,851,302,780,373,104,116,121,96,102,99,113,98,94,109,101,47.44360086767896,202005
巣鴨店,1527,1249,278,1140,387,1038,489,133,138,135,127,153,146,149,149,117,136,144,34.83186549239392,202005
市原店,1189,962,227,878,311,806,383,106,110,93,109,122,123,101,111,98,111,105,33.34199584199584,202005
市川店,1188,943,245,879,309,805,383,111,117,88,102,100,115,109,106,110,106,124,47.23329798515376,202005
平塚店,1178,931,247,868,310,802,376,120,97,116,116,113,119,107,108,94,92,96,34.40386680988185,202005
幸店,1433,1140,293,1069,364,972,461,136,139,132,140,141,131,124,131,129,122,108,35.12368421052632,202005
府中店,1249,1023,226,912,337,848,401,108,114,122,92,125,130,113,108,112,105,120,34.42033235581623,202005
座間店,1365,1132,233,995,370,931,434,124,118,131,114,127,124,134,119,120,116,138,34.402826855123685,202005
志木店,908,717,191,685,223,615,293,82,95,84,82,79,87,80,82,77,69,91,34.99023709902371,202005
恵比寿店,1044,874,170,766,278,706,338,90,90,92,79,111,91,108,110,87,92,94,20.2883295194508,202005
愛甲店,1060,882,178,804,256,720,340,103,97,77,96,84,100,95,93,104,106,105,34.131519274376416,202005
成城店,1373,1104,269,990,383,928,445,121,111,102,126,136,137,144,138,119,123,116,34.02898550724637,202005
成田店,887,743,144,646,241,601,286,77,80,73,74,79,82,73,87,86,102,74,33.912516823687746,202005
我孫子店,1125,933,192,827,298,765,360,101,116,98,111,89,104,107,95,96,99,109,20.013933547695604,202005
戸塚店,1542,1266,276,1145,397,1043,499,127,148,139,148,136,140,153,139,140,131,141,34.048183254344394,202005
戸田店,1545,1262,283,1163,382,1047,498,134,117,137,155,145,154,106,135,133,185,144,34.580824088748024,202005
所沢店,1192,968,224,888,304,808,384,111,112,116,104,99,103,111,109,103,116,108,34.71900826446281,202005
新宿店,1094,898,196,819,275,739,355,97,102,97,98,94,105,114,102,89,107,89,35.406458797327396,202005
新座店,1036,852,184,773,263,703,333,85,100,107,93,107,84,82,105,102,85,86,33.93427230046948,202005
日本橋店,1467,1173,294,1083,384,995,472,132,136,132,127,135,134,128,113,135,138,157,34.7996589940324,202005
日立店,1308,1063,245,950,358,885,423,124,106,125,131,129,102,114,114,131,109,123,34.401693320790216,202005
日野店,1160,957,203,844,316,785,375,100,118,81,100,120,98,116,91,113,108,115,34.78683385579937,202005
旭店,1246,1016,230,929,317,845,401,114,107,110,110,135,111,119,117,111,104,108,34.625984251968504,202005
春日部店,1190,958,232,894,296,803,387,110,112,102,117,101,113,87,110,113,117,108,35.110647181628394,202005
昭島店,1211,990,221,895,316,821,390,94,99,116,109,109,118,116,112,129,100,109,33.83030303030303,202005
木更津店,1129,933,196,840,289,763,366,102,102,111,103,115,92,106,84,107,107,100,35.07717041800643,202005
本庄店,1185,941,244,867,318,805,380,116,113,119,102,115,108,104,105,102,93,108,35.04357066950053,202005
本郷店,761,613,148,535,226,515,246,75,65,59,67,66,73,59,76,64,77,80,46.46818923327896,202005
杉並店,1244,1021,223,948,296,841,403,110,131,117,111,122,125,104,89,117,104,114,33.754162585700286,202005
東中野店,1429,1177,252,1040,389,968,461,131,129,138,155,123,128,124,126,120,129,126,34.38147833474936,202005
東久留米店,876,719,157,626,250,590,286,72,87,95,81,85,74,77,74,78,69,84,34.778859527121,202005
東大和店,1101,914,187,819,282,744,357,96,112,104,92,88,91,103,106,116,96,97,35.338074398249454,202005
東尾久店,1210,1014,196,913,297,816,394,103,94,109,109,129,98,118,104,108,116,122,34.07297830374753,202005
東村山店,1069,879,190,793,276,725,344,90,87,105,101,86,90,103,93,104,117,93,33.762229806598405,202005
東松山店,1334,1084,250,1014,320,907,427,115,134,127,128,134,105,123,120,128,113,107,33.899446494464954,202005
松戸店,1249,998,251,922,327,842,407,109,110,101,120,111,136,103,124,125,95,115,33.736472945891784,202005
板橋店,1089,868,221,821,268,737,352,101,96,101,90,100,106,109,106,101,88,91,46.96198156682028,202005
柏店,1530,1228,302,1153,377,1033,497,156,123,131,142,124,141,133,111,155,154,160,34.27117263843648,202005
栃木店,1094,889,205,792,302,739,355,94,105,86,100,102,100,97,105,114,78,113,34.3599550056243,202005
栄店,1574,1293,281,1163,411,1067,507,152,132,133,159,146,130,130,129,153,148,162,20.588553750966746,202005
桐生店,1247,1013,234,916,331,844,403,100,112,125,124,104,106,118,117,118,111,112,34.29022704837117,202005
横浜南店,1430,1173,257,1090,340,969,461,137,135,118,124,126,146,138,121,121,133,131,35.153452685422,202005
横浜緑店,1310,1075,235,967,343,885,425,120,132,121,104,111,110,127,132,117,124,112,34.44744186046512,202005
横須賀店,1086,874,212,787,299,735,351,92,74,93,108,104,109,102,97,103,100,104,34.75858123569794,202005
武蔵村山店,1312,1074,238,960,352,891,421,117,125,143,94,110,120,116,126,115,119,127,34.62011173184357,202005
武蔵野店,1093,917,176,809,284,744,349,94,101,101,105,111,104,106,99,83,80,109,34.82333696837514,202005
水戸店,1404,1150,254,1025,379,953,451,130,136,143,121,125,132,133,117,115,129,123,34.67043478260869,202005
江戸川店,1187,949,238,877,310,807,380,116,108,111,110,99,108,114,106,108,101,106,34.70916754478398,202005
江東店,1243,1028,215,952,291,842,401,115,121,116,118,121,110,119,101,97,108,117,34.429961089494164,202005
池尻店,1210,999,211,930,280,823,387,102,124,93,101,117,114,115,109,111,110,114,34.015015015015024,202005
池袋店,1464,1169,295,1057,407,991,473,142,136,138,124,120,155,125,132,121,147,124,33.74764756201882,202005
泉店,1483,1200,283,1101,382,1002,481,149,148,151,132,132,147,130,127,115,130,122,34.31916666666667,202005
流山店,1520,1244,276,1132,388,1027,493,128,135,136,137,136,138,138,155,129,161,127,33.355305466237944,202005
浅草店,1395,1126,269,1006,389,947,448,140,113,119,134,120,123,141,136,124,121,124,34.50266429840142,202005
浦和店,1303,1073,230,982,321,882,421,122,118,135,123,110,98,111,128,137,113,108,35.071761416589005,202005
浦安店,1334,1084,250,992,342,904,430,109,122,131,130,100,136,136,135,115,117,103,34.15682656826569,202005
海老名店,1190,987,203,888,302,803,387,123,107,103,100,116,125,102,99,113,109,93,34.695035460992905,202005
清瀬店,1062,883,179,798,264,721,341,109,93,99,111,85,86,85,111,97,95,91,33.927519818799546,202005
渋谷店,1150,939,211,854,296,778,372,106,105,98,101,114,113,108,100,86,110,109,34.46645367412141,202005
港北店,1041,865,176,765,276,707,334,98,80,94,100,89,83,80,99,93,131,94,19.504046242774564,202005
港南店,1247,1013,234,909,338,846,401,108,127,115,115,113,93,131,104,116,110,115,34.409674234945705,202005
瀬谷店,1463,1188,275,1076,387,988,475,139,133,136,141,144,128,141,133,124,115,129,34.675925925925924,202005
熊谷店,1123,929,194,844,279,758,365,113,98,102,100,97,110,101,104,98,96,104,35.17222820236814,202005
狛江店,1252,1038,214,938,314,848,404,109,110,116,98,114,128,121,118,117,98,123,34.27456647398844,202005
狭山店,1420,1155,265,1044,376,958,462,120,103,120,124,128,143,131,124,145,140,142,34.78614718614718,202005
王子店,1161,959,202,862,299,785,376,112,95,111,113,108,113,104,88,93,105,119,20.380604796663192,202005
町田店,1336,1095,241,1024,312,907,429,129,121,129,127,129,123,117,127,103,112,119,34.320547945205476,202005
白井店,1098,885,213,797,301,742,356,120,91,88,90,102,99,100,110,89,114,95,47.40677966101695,202005
目黒店,1209,988,221,866,343,819,390,105,116,111,107,106,124,122,99,108,119,92,34.243927125506076,202005
相模原店,1494,1204,290,1128,366,1016,478,142,138,135,152,126,128,123,124,144,149,133,34.283222591362126,202005
石神井店,966,788,178,720,246,655,311,91,78,84,96,83,90,96,91,84,85,88,48.220812182741106,202005
磯子店,945,780,165,703,242,639,306,75,77,82,91,75,92,79,97,84,94,99,35.2525641025641,202005
神奈川店,1394,1132,262,1044,350,941,453,132,131,129,118,125,112,140,124,121,127,135,34.72349823321555,202005
神田店,1463,1202,261,1110,353,991,472,123,140,129,171,128,153,113,134,126,108,138,35.202163061564065,202005
福生店,1371,1111,260,1035,336,927,444,95,128,133,151,94,135,147,104,132,120,132,34.64086408640864,202005
秦野店,1248,1026,222,913,335,844,404,95,94,110,112,127,127,119,115,105,128,116,34.244639376218316,202005
稲城店,969,778,191,700,269,658,311,94,94,89,84,99,69,90,80,85,90,95,47.4948586118252,202005
立川店,1306,1076,230,978,328,885,421,98,131,114,132,129,112,118,107,134,104,127,35.316914498141266,202005
綾瀬店,2698,2216,482,2013,685,1827,871,239,240,252,247,239,255,258,261,217,258,232,34.186371841155236,202005
練馬店,1423,1166,257,1050,373,962,461,131,129,122,131,152,137,126,135,115,125,120,34.4811320754717,202005
羽村店,1396,1165,231,1037,359,945,451,118,123,136,132,133,109,127,136,128,128,126,19.98197424892704,202005
羽生店,1331,1074,257,967,364,902,429,127,128,116,112,127,124,116,118,114,141,108,34.747672253258855,202005
習志野店,1435,1160,275,1038,397,973,462,123,123,148,129,137,127,125,132,123,126,142,34.08362068965517,202005
自由が丘店,1299,1033,266,973,326,880,419,121,106,135,125,132,127,114,95,113,109,122,33.95643756050339,202005
船橋店,1491,1195,296,1104,387,1013,478,139,144,102,129,152,161,125,140,127,151,121,34.318828451882844,202005
若葉店,1183,968,215,893,290,799,384,109,115,105,92,101,105,111,123,110,111,101,35.478305785123965,202005
茂原店,1363,1110,253,1015,348,925,438,132,126,113,128,133,127,119,111,119,127,128,34.87297297297297,202005
茅ヶ崎店,914,733,181,688,226,621,293,81,81,82,90,75,90,85,97,60,73,100,33.69577080491133,202005
草加店,1006,828,178,762,244,681,325,104,88,84,87,96,89,99,101,84,84,90,33.946859903381636,202005
荒川店,914,728,186,686,228,620,294,98,69,107,96,84,86,64,76,75,81,78,35.122252747252745,202005
荻窪店,1240,1042,198,904,336,840,400,104,113,121,111,113,117,108,108,117,117,111,20.632437619961614,202005
葛飾店,1148,928,220,842,306,776,372,88,96,125,111,88,111,112,114,100,97,106,34.1584051724138,202005
蒲田店,1038,841,197,772,266,701,337,79,115,81,111,97,104,72,95,101,89,94,33.586206896551715,202005
藤沢店,1191,980,211,865,326,806,385,117,101,98,105,105,109,136,99,108,102,111,34.160204081632656,202005
行田店,998,801,197,772,226,671,327,84,83,86,87,95,99,88,97,88,91,100,34.31210986267166,202005
西多摩店,1580,1268,312,1175,405,1074,506,153,149,147,133,157,134,134,153,141,127,152,34.111987381703464,202005
西東京店,1000,820,180,738,262,675,325,89,91,104,68,87,79,91,94,100,96,101,35.795121951219514,202005
西葛西店,811,655,156,606,205,549,262,73,71,75,82,69,71,73,77,77,70,73,35.45038167938932,202005
調布店,1423,1156,267,1009,414,964,459,120,132,106,134,129,133,143,139,142,121,124,34.63581314878893,202005
谷中店,1554,1247,307,1168,386,1050,504,102,121,160,155,150,161,130,138,139,165,133,34.485966319166,202005
赤坂店,1036,860,176,768,268,701,335,89,90,91,102,86,105,85,99,103,97,89,34.336046511627906,202005
赤羽店,1183,963,220,889,294,799,384,107,107,100,114,106,120,98,116,98,114,103,47.26479750778815,202005
越谷店,917,732,185,684,233,621,296,97,65,79,86,86,72,80,87,80,71,114,47.050546448087424,202005
足利店,819,675,144,611,208,554,265,84,64,84,65,74,67,73,70,74,83,81,34.44,202005
足柄上店,1244,1019,225,910,334,840,404,104,118,102,121,126,114,123,113,119,104,100,34.732090284592736,202005
足立店,876,712,164,634,242,593,283,80,73,80,86,69,88,93,90,75,65,77,34.925561797752806,202005
逗子店,1091,901,190,810,281,744,347,106,78,93,111,97,115,95,99,95,100,102,34.3118756936737,202005
那珂店,1226,1015,211,932,294,831,395,126,97,108,120,105,112,103,123,92,108,132,20.595073891625614,202005
都筑店,1034,860,174,763,271,701,333,82,100,93,95,81,90,94,96,118,98,87,33.84418604651163,202005
金沢店,1274,1071,203,957,317,868,406,120,113,122,127,121,115,116,83,119,119,119,20.26704014939309,202005
銀座店,1006,802,204,763,243,681,325,102,77,90,94,95,86,102,94,81,85,100,34.35286783042394,202005
鎌倉店,1003,818,185,743,260,682,321,89,91,88,92,91,90,97,96,81,86,102,34.76283618581907,202005
青山店,1367,1109,258,1026,341,923,444,113,132,137,105,105,144,104,127,131,145,124,34.5356176735798,202005
青梅店,1267,1033,234,912,355,857,410,112,105,131,98,117,113,112,127,105,128,119,33.957405614714425,202005
青葉店,1152,932,220,864,288,780,372,99,104,112,107,110,129,82,108,113,100,88,34.762875536480685,202005
館林店,1188,961,227,875,313,802,386,116,95,106,96,104,113,110,125,94,110,119,34.711758584807484,202005
駒沢店,1038,828,210,760,278,705,333,87,89,93,93,98,72,97,88,109,96,116,33.94323671497585,202005
駒込店,1489,1229,260,1084,405,1004,485,129,119,142,134,137,155,122,146,149,139,117,34.1440195280716,202005
高円寺店,1431,1148,283,1062,369,971,460,128,131,118,143,132,127,132,135,132,134,119,34.31794425087108,202005
高島平店,1244,991,253,901,343,842,402,115,124,122,105,113,105,105,122,107,115,111,34.709384460141266,202005
高崎店,1152,932,220,834,318,787,365,111,108,81,96,98,102,116,106,102,102,130,34.91630901287554,202005
高座店,1147,942,205,856,291,781,366,102,98,77,103,105,131,111,108,91,115,106,33.866242038216555,202005
高津店,1155,933,222,841,314,778,377,94,93,107,105,107,111,111,108,107,111,101,34.35048231511255,202005
高田馬場店,1096,891,205,826,270,744,352,107,107,92,93,105,90,95,102,101,106,98,34.7351290684624,202005
鴻巣店,1146,941,205,850,296,781,365,101,98,106,115,100,103,107,100,113,115,88,33.218916046758764,202005
鶴見店,1522,1277,245,1120,402,1033,489,145,123,139,142,143,138,155,134,135,134,134,34.278778386844174,202005
麻生店,1402,1139,263,1034,368,948,454,112,122,131,128,121,126,134,127,140,127,134,34.21949078138718,202005
あきる野店,1147,925,222,831,316,839,308,102,98,106,103,109,99,100,106,105,112,107,35.4,202006
さいたま南店,1502,1227,275,1103,399,1103,399,159,134,133,121,117,145,139,148,147,128,131,35.23308883455583,202006
さいたま緑店,1031,848,183,786,245,754,277,110,80,79,92,105,96,91,94,87,94,103,35.39740566037736,202006
さいたま西店,1180,946,234,878,302,865,315,99,123,116,90,104,99,107,114,101,104,123,34.307610993657505,202006
つくば店,1264,1023,241,949,315,928,336,111,106,115,110,103,120,122,124,123,102,128,34.80449657869013,202006
三浦店,1137,942,195,860,277,831,306,109,97,111,105,101,107,89,98,101,96,123,33.84288747346072,202006
三鷹店,1494,1217,277,1101,393,1092,402,132,129,143,141,116,142,153,129,143,129,137,34.43056696795398,202006
上尾店,1325,1128,197,981,344,972,353,124,120,101,137,136,111,114,112,113,131,126,20.43971631205674,202006
上野店,1627,1340,287,1220,407,1197,430,146,152,140,159,128,138,149,158,154,155,148,34.47313432835821,202006
世田谷店,1527,1227,300,1139,388,1120,407,144,137,150,129,139,140,140,133,138,116,161,34.66829665851671,202006
中原店,1525,1239,286,1124,401,1115,410,118,136,136,151,137,130,144,141,148,145,139,34.34786117836965,202006
中店,1197,967,230,903,294,874,323,104,120,101,108,117,105,104,113,116,111,98,34.510858324715606,202006
中野店,1148,929,219,841,307,841,307,90,106,121,117,107,103,105,99,91,111,98,34.43810548977395,202006
久喜店,1291,1081,210,976,315,944,347,123,125,124,137,110,118,99,105,107,109,134,33.943570767807586,202006
九段店,1317,1089,228,981,336,965,352,108,140,136,115,123,96,129,120,118,122,110,34.296602387511484,202006
亀有店,1031,831,200,762,269,755,276,96,104,86,78,117,74,89,95,82,106,104,34.47773766546329,202006
五反田店,1149,936,213,840,309,839,310,86,116,80,132,100,123,90,116,89,102,115,34.49145299145299,202006
代々木店,1357,1112,245,1023,334,996,361,126,117,133,126,130,120,116,131,123,102,133,33.884892086330936,202006
伊勢原店,1435,1156,279,1046,389,1052,383,133,145,136,129,124,125,128,133,122,133,127,34.011245674740486,202006
伊勢崎店,1588,1318,270,1179,409,1165,423,121,146,166,129,149,140,129,157,154,150,147,34.07890743550835,202006
佐倉店,888,745,143,645,243,653,235,77,91,84,79,74,73,79,98,87,65,81,33.75704697986577,202006
佐野店,1494,1205,289,1110,384,1096,398,140,138,132,147,137,118,141,145,118,149,129,34.73526970954357,202006
保土ケ谷店,1264,1034,230,909,355,932,332,117,120,111,121,120,116,116,122,86,118,117,34.12185686653772,202006
入間店,1141,944,197,848,293,835,306,113,98,81,108,130,103,102,83,108,103,112,34.114406779661024,202006
八千代店,1234,1007,227,937,297,905,329,107,110,114,106,115,102,119,119,121,107,114,34.18867924528302,202006
八潮店,1207,998,209,879,328,885,322,116,96,109,127,120,107,104,112,101,121,94,33.77855711422845,202006
八王子店,1516,1249,267,1106,410,1111,405,130,154,146,137,111,136,133,145,131,144,149,34.82866293034427,202006
六本木店,1001,802,199,721,280,734,267,89,92,78,93,79,84,89,98,96,97,106,35.29800498753117,202006
前橋店,821,661,160,623,198,600,221,80,74,81,73,74,65,71,82,61,83,77,33.662632375189105,202006
北千住店,1002,814,188,756,246,734,268,98,81,84,96,75,88,83,104,104,94,95,34.54299754299754,202006
千葉中央店,1262,1026,236,934,328,923,339,100,138,107,91,112,108,116,114,127,130,119,34.89473684210526,202006
千葉緑店,1153,926,227,848,305,846,307,110,114,112,87,101,104,102,102,116,96,109,35.278617710583156,202006
南砂店,1258,1032,226,951,307,923,335,116,101,116,129,107,102,118,125,121,125,98,35.093023255813954,202006
南足柄店,992,793,199,723,269,723,269,89,89,99,87,83,88,91,82,79,105,100,33.58890290037831,202006
厚木店,1445,1172,273,1067,378,1059,386,133,120,134,136,134,142,149,124,129,127,117,34.96928327645051,202006
取手店,1145,925,220,834,311,838,307,103,96,101,110,106,100,104,105,113,102,105,34.73189189189189,202006
向島店,1033,834,199,756,277,759,274,97,112,91,81,93,87,87,112,85,99,89,35.0779376498801,202006
君津店,1086,875,211,813,273,796,290,107,86,95,104,83,103,91,113,116,104,84,35.265142857142855,202006
和光店,1293,1058,235,935,358,952,341,122,134,120,123,127,104,112,117,114,102,118,34.23818525519849,202006
品川店,1448,1145,303,1067,381,1061,387,154,137,136,120,140,132,125,107,142,116,139,34.41048034934498,202006
四街道店,824,677,147,580,244,603,221,76,80,67,66,76,77,75,83,73,82,69,34.96602658788774,202006
国分寺店,975,793,182,717,258,716,259,92,96,104,82,83,81,83,86,79,107,82,34.96595208070618,202006
国立店,1352,1103,249,985,367,987,365,137,121,117,110,124,117,128,126,120,113,139,33.9728014505893,202006
坂戸店,1146,938,208,851,295,842,304,92,110,108,116,88,114,106,106,86,109,111,34.24307036247335,202006
墨田店,969,779,190,693,276,709,260,75,80,82,85,93,89,76,94,89,115,91,34.20410783055198,202006
多摩店,1059,855,204,755,304,778,281,93,100,87,82,84,98,114,101,96,107,97,35.16842105263158,202006
大久保店,1025,828,197,759,266,749,276,82,100,93,74,95,102,100,99,89,95,96,35.04106280193237,202006
大井店,1175,969,206,885,290,862,313,103,113,97,117,92,104,108,118,121,103,99,34.5108359133127,202006
大和店,1322,1100,222,971,351,972,350,121,136,102,114,130,122,98,126,117,132,124,34.31818181818182,202006
大塚店,1084,861,223,792,292,793,291,89,105,112,93,89,114,101,90,84,98,109,34.145180023228804,202006
大宮店,1317,1076,241,999,318,963,354,123,112,123,135,122,118,114,121,126,99,124,34.43773234200744,202006
大森店,1383,1124,259,1003,380,1012,371,131,118,129,103,137,115,133,129,124,141,123,34.763345195729535,202006
大泉店,1179,945,234,867,312,862,317,104,109,128,108,109,86,103,99,108,115,110,34.74074074074074,202006
大田店,914,771,143,705,209,670,244,87,81,77,79,84,85,90,77,82,85,87,34.673151750972764,202006
太田店,1323,1089,234,960,363,971,352,139,122,108,117,131,112,143,117,109,114,111,34.898989898989896,202006
宇都宮店,1060,880,180,791,269,775,285,97,100,100,78,105,84,95,97,103,108,93,34.527272727272724,202006
守谷店,1147,924,223,844,303,839,308,96,100,117,103,113,104,122,75,101,108,108,34.3051948051948,202006
宮前店,706,583,123,532,174,522,184,77,59,50,71,59,72,63,60,72,72,51,35.228130360205824,202006
富岡店,1060,855,205,757,303,778,282,96,89,104,88,99,98,89,93,104,99,101,33.33684210526316,202006
富津店,1003,835,168,738,265,735,268,110,71,105,71,100,88,95,94,89,93,87,34.29820359281437,202006
富里店,1445,1177,268,1073,372,1062,383,140,125,139,127,123,122,118,127,149,135,140,34.07561597281224,202006
小山店,1000,814,186,739,261,735,265,78,105,103,94,96,86,80,87,96,93,82,34.565110565110565,202006
小平店,973,785,188,703,270,715,258,74,93,96,95,95,76,99,95,98,73,79,34.745222929936304,202006
小田原店,885,731,154,653,232,652,233,78,101,83,80,93,64,75,80,77,80,74,33.92202462380301,202006
小金井店,1061,870,191,807,254,779,282,110,102,95,87,96,90,106,91,92,101,91,34.140229885057465,202006
川口店,1081,882,199,782,299,791,290,114,101,113,93,82,91,97,102,90,114,84,34.151927437641724,202006
川崎多摩店,1080,879,201,771,309,794,286,93,100,113,101,99,94,87,103,98,95,97,34.90898748577929,202006
川崎店,1179,950,229,887,292,863,316,97,99,89,115,109,115,112,113,106,116,108,46.94526315789474,202006
川越店,1119,881,238,808,311,821,298,90,96,104,101,100,99,103,119,104,100,103,48.0771850170261,202006
巣鴨店,1463,1196,267,1105,358,1075,388,140,105,105,133,142,155,137,131,140,136,139,34.785117056856194,202006
市原店,1155,948,207,859,296,848,307,100,99,84,114,101,101,105,124,103,114,110,35.02320675105485,202006
市川店,1145,934,211,822,323,838,307,99,93,101,103,97,124,110,122,104,101,91,48.46359743040685,202006
平塚店,1150,942,208,885,265,842,308,107,94,114,109,103,99,97,123,109,115,80,34.07430997876857,202006
幸店,1385,1122,263,1028,357,1014,371,153,117,138,119,139,101,137,106,126,122,127,34.236185383244205,202006
府中店,1211,988,223,915,296,885,326,116,101,120,103,114,120,104,106,102,117,108,34.435222672064775,202006
座間店,1328,1083,245,972,356,976,352,115,123,136,133,117,138,116,109,115,123,103,35.608494921514314,202006
志木店,882,737,145,662,220,645,237,74,71,89,85,83,84,96,76,79,74,71,34.324287652645864,202006
恵比寿店,997,814,183,748,249,730,267,98,83,92,96,93,73,90,99,94,91,88,20.37469287469288,202006
愛甲店,1030,845,185,743,287,754,276,75,90,98,100,79,86,89,114,87,101,111,33.8603550295858,202006
成城店,1332,1095,237,977,355,978,354,127,123,119,124,132,135,111,126,108,119,108,34.009132420091326,202006
成田店,847,675,172,664,183,619,228,75,85,61,92,78,79,88,66,73,84,66,34.96,202006
我孫子店,1087,916,171,791,296,797,290,93,110,94,107,95,97,108,94,92,98,99,20.38864628820961,202006
戸塚店,1499,1230,269,1098,401,1098,401,148,135,136,143,130,124,140,141,117,135,150,34.81219512195122,202006
戸田店,1499,1221,278,1132,367,1099,400,134,130,141,135,131,140,143,137,144,124,140,34.34070434070434,202006
所沢店,1144,937,207,837,307,837,307,103,95,94,119,113,110,95,118,103,91,103,35.182497331910355,202006
新宿店,1057,866,191,813,244,775,282,122,96,99,98,97,82,77,99,102,91,94,34.02193995381062,202006
新座店,998,806,192,746,252,733,265,87,73,93,78,100,88,92,107,83,103,94,35.18486352357321,202006
日本橋店,1414,1169,245,1054,360,1039,375,120,118,129,119,144,118,137,120,129,153,127,34.25834046193328,202006
日立店,1266,1044,222,927,339,929,337,131,126,123,108,120,103,107,105,135,118,90,34.07854406130268,202006
日野店,1120,890,230,811,309,822,298,86,98,88,99,101,98,109,100,124,96,121,33.96179775280899,202006
旭店,1215,997,218,896,319,891,324,108,118,110,111,105,107,115,100,111,114,116,34.948846539618856,202006
春日部店,1145,937,208,844,301,840,305,112,102,94,120,104,111,98,103,93,108,100,34.40875133404481,202006
昭島店,1176,941,235,850,326,864,312,120,109,100,107,114,105,97,113,118,100,93,34.681190223166844,202006
木更津店,1083,882,201,800,283,794,289,90,96,109,91,96,87,91,110,119,93,101,34.63378684807256,202006
本庄店,1147,937,210,839,308,841,306,117,93,99,106,106,111,102,109,103,107,94,33.992529348986125,202006
本郷店,736,590,146,550,186,540,196,54,69,64,56,63,70,82,64,69,74,71,47.92711864406779,202006
杉並店,1209,949,260,882,327,890,319,121,109,110,112,111,118,110,94,102,123,99,34.55005268703899,202006
東中野店,1382,1160,222,1010,372,1013,369,122,109,122,110,117,148,123,135,131,135,130,34.09051724137931,202006
東久留米店,849,696,153,620,229,624,225,78,69,79,78,79,82,93,68,75,76,72,34.10919540229885,202006
東大和店,1058,873,185,793,265,775,283,105,99,102,84,103,82,93,79,102,100,109,34.185567010309285,202006
東尾久店,1172,968,204,873,299,861,311,105,113,103,115,109,125,101,120,91,93,97,34.95454545454545,202006
東村山店,1030,865,165,746,284,757,273,92,93,86,94,86,89,108,100,93,95,94,33.104046242774565,202006
東松山店,1288,1066,222,983,305,947,341,122,124,118,101,121,102,107,114,131,130,118,34.69512195121951,202006
松戸店,1206,980,226,869,337,884,322,106,112,133,98,108,104,104,103,114,103,121,34.60306122448979,202006
板橋店,1060,857,203,775,285,775,285,95,89,94,91,117,106,78,86,110,98,96,47.649941656942815,202006
柏店,1467,1210,257,1105,362,1075,392,108,137,144,153,135,117,124,138,141,129,141,35.209090909090904,202006
栃木店,1059,852,207,789,270,776,283,100,94,106,97,97,97,91,98,101,94,84,34.29225352112676,202006
栄店,1524,1258,266,1105,419,1116,408,159,142,135,140,146,126,135,127,141,121,152,20.05325914149444,202006
桐生店,1215,990,225,898,317,890,325,133,110,110,96,107,96,109,114,116,118,106,35.17979797979797,202006
横浜南店,1388,1130,258,1042,346,1017,371,135,124,118,143,139,112,116,122,134,123,122,33.8566371681416,202006
横浜緑店,1258,1018,240,939,319,923,335,134,108,99,116,104,125,117,112,118,119,106,34.446954813359525,202006
横須賀店,1051,866,185,786,265,770,281,93,102,89,88,90,107,85,112,95,99,91,34.68822170900693,202006
武蔵村山店,1262,1031,231,942,320,927,335,114,122,107,130,109,111,136,105,109,111,108,34.600387972841894,202006
武蔵野店,1058,847,211,791,267,775,283,88,98,94,91,92,98,83,106,82,109,117,33.69067296340024,202006
水戸店,1343,1081,262,1003,340,981,362,113,105,139,133,126,128,109,122,115,113,140,34.77798334875116,202006
江戸川店,1146,932,214,816,330,842,304,97,110,115,107,122,94,104,97,96,109,95,34.92489270386266,202006
江東店,1214,992,222,889,325,891,323,120,116,121,111,126,102,115,115,91,79,118,34.24596774193548,202006
池尻店,1170,971,199,859,311,855,315,96,114,103,89,118,112,107,106,117,111,97,35.31101956745623,202006
池袋店,1409,1152,257,1035,374,1030,379,117,142,122,156,143,129,96,134,120,127,123,34.420138888888886,202006
泉店,1443,1181,262,1051,392,1059,384,160,130,111,134,141,124,128,134,125,123,133,34.87044877222693,202006
流山店,1479,1188,291,1088,391,1085,394,120,159,128,136,136,133,120,139,131,150,127,33.804713804713806,202006
浅草店,1361,1112,249,1048,313,1000,361,124,106,122,108,122,144,136,135,123,121,120,34.23381294964029,202006
浦和店,1267,1034,233,934,333,931,336,133,118,119,117,117,98,118,115,113,113,106,34.167311411992266,202006
浦安店,1295,1057,238,971,324,953,342,118,112,108,116,121,117,121,127,117,114,124,34.19678334910123,202006
海老名店,1148,924,224,834,314,839,309,131,98,113,104,103,104,110,105,91,82,107,35.20021645021646,202006
清瀬店,1032,843,189,779,253,757,275,93,101,80,106,93,78,93,105,89,99,95,35.09252669039146,202006
渋谷店,1113,913,200,837,276,814,299,96,109,94,118,100,106,105,96,105,88,96,34.085432639649504,202006
港北店,1002,824,178,742,260,736,266,87,92,78,97,107,83,86,94,98,95,85,21.070388349514566,202006
港南店,1207,981,226,902,305,888,319,121,111,109,110,113,100,126,103,98,109,107,35.15290519877676,202006
瀬谷店,1402,1157,245,1054,348,1033,369,113,138,117,116,120,150,105,148,133,136,126,34.6076058772688,202006
熊谷店,1089,898,191,799,290,796,293,90,104,103,108,104,100,107,91,92,94,96,34.589086859688194,202006
狛江店,1211,984,227,860,351,886,325,107,95,99,110,132,95,92,114,128,125,114,34.51930894308943,202006
狭山店,1381,1137,244,1013,368,1015,366,118,115,137,115,120,145,120,125,133,120,133,34.9806508355321,202006
王子店,1123,930,193,847,276,825,298,97,104,91,98,103,121,96,102,99,113,99,20.455913978494625,202006
町田店,1295,1059,236,991,304,947,348,128,120,119,107,112,106,121,133,121,124,104,34.87440982058545,202006
白井店,1067,841,226,778,289,783,284,90,94,102,111,97,98,87,101,90,101,96,49.42211652794293,202006
目黒店,1170,946,224,867,303,859,311,96,124,129,100,95,108,108,95,98,112,105,35.040169133192386,202006
相模原店,1442,1176,266,1058,384,1059,383,131,145,135,120,126,142,137,113,132,116,145,34.78486394557823,202006
石神井店,941,753,188,702,239,692,249,89,80,77,104,79,79,99,90,87,80,77,47.992031872509955,202006
磯子店,912,748,164,677,235,667,245,71,85,74,83,68,90,91,90,84,91,85,34.367647058823536,202006
神奈川店,1339,1092,247,1022,317,980,359,118,121,133,130,120,118,116,125,116,116,126,34.36904761904762,202006
神田店,1416,1172,244,1043,373,1036,380,146,122,118,133,122,131,133,129,122,132,128,34.410409556313994,202006
福生店,1327,1075,252,975,352,972,355,112,123,113,111,105,106,129,129,123,138,138,34.79348837209302,202006
秦野店,1205,981,224,908,297,882,323,102,106,117,109,115,132,111,89,115,111,98,34.783893985728845,202006
稲城店,942,769,173,709,233,691,251,89,80,83,87,101,78,84,85,94,81,80,46.63459037711314,202006
立川店,1269,1026,243,888,381,929,340,116,135,112,112,113,130,132,92,100,128,99,35.219298245614034,202006
綾瀬店,2616,2145,471,1910,706,1925,691,239,227,248,251,220,244,253,220,246,226,242,34.9002331002331,202006
練馬店,1380,1126,254,1040,340,1014,366,142,131,141,135,117,133,118,108,125,125,105,34.1651865008881,202006
羽村店,1351,1116,235,972,379,989,362,128,113,123,103,130,119,129,132,129,121,124,20.54749103942652,202006
羽生店,1303,1066,237,961,342,957,346,120,139,101,121,113,134,101,134,101,119,120,35.68667917448405,202006
習志野店,1382,1155,227,1008,374,1012,370,136,122,135,151,109,119,102,134,142,119,113,34.0961038961039,202006
自由が丘店,1264,1024,240,943,321,925,339,114,100,111,120,132,110,103,119,110,117,128,33.58203125,202006
船橋店,1450,1185,265,1063,387,1065,385,158,134,114,130,125,131,132,130,129,152,115,34.2379746835443,202006
若葉店,1149,949,200,832,317,842,307,94,98,119,101,72,109,119,118,85,123,111,34.87776606954689,202006
茂原店,1314,1037,277,951,363,961,353,107,118,119,99,107,115,135,115,122,137,140,33.877531340405014,202006
茅ヶ崎店,875,724,151,643,232,645,230,87,65,79,78,83,68,80,72,87,87,89,35.345303867403324,202006
草加店,968,805,163,723,245,707,261,96,95,85,89,96,81,81,85,99,71,90,34.417391304347824,202006
荒川店,884,711,173,664,220,649,235,78,71,73,82,73,94,81,97,80,84,71,34.62306610407876,202006
荻窪店,1202,982,220,876,326,884,318,105,95,97,112,126,112,113,110,110,112,110,20.38289205702648,202006
葛飾店,1126,918,208,848,278,826,300,121,107,102,95,85,102,113,99,92,96,114,34.30936819172113,202006
蒲田店,1001,832,169,763,238,735,266,88,107,99,94,78,88,85,109,95,82,76,35.021634615384606,202006
藤沢店,1147,934,213,828,319,839,308,112,103,122,100,88,99,94,103,113,109,104,34.79764453961456,202006
行田店,971,790,181,710,261,713,258,89,94,94,86,92,87,81,89,94,76,89,34.831645569620264,202006
西多摩店,1541,1263,278,1128,413,1128,413,130,112,140,138,161,141,151,151,144,145,128,35.19398258115598,202006
西東京店,971,806,165,701,270,712,259,91,99,87,87,90,91,76,83,86,92,89,33.988833746898266,202006
西葛西店,786,637,149,556,230,580,206,86,69,71,66,62,80,77,65,59,78,73,34.915227629513346,202006
調布店,1384,1137,247,1043,341,1019,365,136,119,144,129,117,116,120,117,135,130,121,34.14599824098505,202006
谷中店,1494,1215,279,1119,375,1099,395,133,131,141,145,120,131,137,155,144,119,138,34.184362139917695,202006
赤坂店,994,823,171,747,247,726,268,89,96,76,106,95,91,69,99,82,87,104,35.11907654921021,202006
赤羽店,1145,922,223,831,314,842,303,114,116,108,86,110,113,96,98,102,91,111,46.281995661605215,202006
越谷店,874,688,186,624,250,641,233,76,81,75,81,73,86,67,91,82,91,71,46.35029069767442,202006
足利店,787,637,150,571,216,580,207,80,79,73,64,55,70,81,74,57,73,81,34.974882260596544,202006
足柄上店,1205,975,230,921,284,881,324,96,103,123,114,97,110,124,109,111,100,118,34.220512820512816,202006
足立店,853,690,163,623,230,626,227,77,87,79,72,81,68,82,81,82,80,64,34.25507246376812,202006
逗子店,1064,864,200,821,243,781,283,102,101,92,81,108,100,105,101,88,91,95,34.94328703703704,202006
那珂店,1180,976,204,882,298,864,316,129,88,118,99,113,109,100,87,113,95,129,19.962090163934427,202006
都筑店,998,817,181,749,249,737,261,85,95,96,96,95,95,96,81,81,89,89,34.18359853121175,202006
金沢店,1238,1022,216,923,315,909,329,129,119,110,120,124,102,95,104,105,113,117,19.99412915851272,202006
銀座店,962,784,178,708,254,706,256,93,110,101,76,71,94,74,92,84,81,86,34.79209183673469,202006
鎌倉店,974,815,159,706,268,718,256,83,88,96,87,88,97,81,98,95,89,72,33.790184049079755,202006
青山店,1319,1078,241,971,348,968,351,133,128,124,99,120,131,104,115,120,113,132,34.56400742115028,202006
青梅店,1239,1007,232,978,261,909,330,114,111,114,103,107,108,121,117,124,108,112,33.95332671300893,202006
青葉店,1114,921,193,840,274,817,297,116,107,102,95,106,88,104,109,112,98,77,35.0271444082519,202006
館林店,1149,919,230,842,307,844,305,99,117,87,137,106,90,113,105,104,101,90,34.49183895538629,202006
駒沢店,1004,831,173,737,267,736,268,85,92,98,87,107,88,90,75,99,98,85,34.51263537906137,202006
駒込店,1433,1144,289,1059,374,1057,376,121,138,130,128,128,144,131,130,144,122,117,34.4222027972028,202006
高円寺店,1386,1108,278,1030,356,1018,368,121,118,113,139,151,102,154,114,113,126,135,35.69043321299639,202006
高島平店,1213,986,227,914,299,890,323,110,129,113,109,113,99,125,97,92,106,120,34.752535496957414,202006
高崎店,1115,925,190,808,307,817,298,111,89,107,89,135,107,83,116,84,88,106,34.67027027027027,202006
高座店,1114,909,205,824,290,815,299,91,91,95,86,119,98,117,115,106,96,100,34.31793179317932,202006
高津店,1117,909,208,840,277,821,296,91,118,97,109,102,106,97,90,102,112,93,34.31463146314631,202006
高田馬場店,1059,830,229,769,290,777,282,90,110,114,100,81,97,95,92,95,81,104,34.99759036144578,202006
鴻巣店,1117,923,194,830,287,821,296,102,106,109,116,86,106,95,101,103,96,97,34.695557963163594,202006
鶴見店,1464,1199,265,1059,405,1071,393,138,134,117,135,154,145,125,134,133,125,124,34.882402001668055,202006
麻生店,1352,1112,240,1017,335,994,358,116,111,120,118,110,138,122,111,140,134,132,34.38309352517986,202006
あきる野店,1179,945,234,846,333,876,303,96,125,115,107,98,110,111,104,112,106,95,33.991534391534394,202007
さいたま南店,1550,1248,302,1189,361,1152,398,132,142,150,149,147,139,127,121,148,140,155,34.907051282051285,202007
さいたま緑店,1053,864,189,778,275,778,275,96,87,108,99,107,90,91,95,96,100,84,34.232638888888886,202007
さいたま西店,1212,972,240,924,288,899,313,125,103,112,117,112,115,108,112,97,113,98,34.063786008230444,202007
つくば店,1306,1082,224,940,366,967,339,120,116,107,113,127,124,113,113,102,138,133,35.17097966728281,202007
三浦店,1181,939,242,870,311,878,303,115,100,91,115,112,132,105,101,105,103,102,34.90521831735889,202007
三鷹店,1554,1280,274,1147,407,1152,402,150,111,145,150,155,144,149,139,128,150,133,34.52265625,202007
上尾店,1367,1108,259,1023,344,1017,350,130,130,121,107,127,121,116,131,118,123,143,20.46750902527076,202007
上野店,1666,1371,295,1251,415,1235,431,138,157,160,134,146,169,142,155,166,163,136,33.89059080962801,202007
世田谷店,1575,1283,292,1144,431,1172,403,154,144,144,134,152,150,121,122,156,141,157,34.381137957911136,202007
中原店,1567,1287,280,1170,397,1158,409,145,133,145,139,144,145,142,136,154,156,128,34.44910644910645,202007
中店,1253,1017,236,923,330,931,322,87,150,89,120,119,113,146,113,110,87,119,34.57227138643068,202007
中野店,1194,966,228,910,284,884,310,105,110,101,126,102,105,109,112,112,108,104,34.6055900621118,202007
久喜店,1338,1079,259,997,341,992,346,115,113,137,125,130,117,113,110,137,119,122,34.39944392956441,202007
九段店,1374,1139,235,1045,329,1024,350,130,117,113,138,127,102,136,128,131,133,119,34.15452151009658,202007
亀有店,1055,833,222,784,271,783,272,88,101,104,101,101,119,79,73,105,92,92,34.57142857142857,202007
五反田店,1184,970,214,890,294,877,307,107,104,126,94,120,108,100,105,95,112,113,34.04536082474227,202007
代々木店,1396,1142,254,1034,362,1035,361,129,125,133,126,134,126,141,128,113,120,121,34.57968476357268,202007
伊勢原店,1491,1225,266,1097,394,1108,383,146,143,133,131,138,123,135,118,129,158,137,34.618775510204074,202007
伊勢崎店,1639,1372,267,1241,398,1216,423,141,145,153,149,157,141,148,144,162,144,155,34.0131195335277,202007
佐倉店,912,739,173,641,271,676,236,90,76,78,95,105,74,90,70,80,75,79,34.94722598105548,202007
佐野店,1556,1233,323,1156,400,1153,403,147,133,149,143,145,132,141,141,138,146,141,34.824006488240066,202007
保土ケ谷店,1301,1056,245,961,340,964,337,126,117,103,128,101,130,134,103,112,118,129,34.35321969696969,202007
入間店,1183,975,208,855,328,874,309,108,113,95,98,123,116,109,119,97,96,109,34.408205128205125,202007
八千代店,1281,1048,233,943,338,949,332,119,122,117,112,92,129,113,129,129,104,115,34.32156488549618,202007
八潮店,1244,1038,206,914,330,921,323,126,129,99,112,110,96,119,106,117,116,114,34.139691714836225,202007
八王子店,1583,1308,275,1165,418,1175,408,149,156,144,130,142,140,148,153,139,132,150,34.31651376146789,202007
六本木店,1036,853,183,758,278,768,268,91,94,102,95,92,88,95,92,104,89,94,35.263774912075036,202007
前橋店,852,678,174,614,238,632,220,59,88,63,73,87,76,90,78,73,81,84,34.38200589970501,202007
北千住店,1030,835,195,731,299,768,262,90,87,89,102,99,91,86,111,99,80,96,34.27065868263473,202007
千葉中央店,1305,1048,257,978,327,966,339,110,121,123,112,114,105,134,119,110,124,133,34.61354961832061,202007
千葉緑店,1186,979,207,895,291,876,310,124,94,94,85,118,115,91,118,110,118,119,34.43922369765066,202007
南砂店,1304,1052,252,980,324,967,337,130,125,116,98,133,123,100,117,114,126,122,34.402091254752854,202007
南足柄店,1035,835,200,752,283,768,267,90,92,101,89,98,90,86,94,84,107,104,34.705389221556885,202007
厚木店,1487,1208,279,1091,396,1104,383,143,135,132,128,133,122,153,145,135,129,132,34.098509933774835,202007
取手店,1176,964,212,885,291,874,302,85,112,101,109,116,109,93,110,104,122,115,35.04253112033195,202007
向島店,1060,871,189,763,297,789,271,106,93,107,95,90,105,102,81,100,88,93,35.25028702640643,202007
君津店,1126,937,189,802,324,835,291,80,89,113,100,98,104,105,89,99,125,124,33.94770544290288,202007
和光店,1339,1100,239,976,363,994,345,114,128,118,120,108,124,125,152,119,99,132,34.64727272727273,202007
品川店,1483,1224,259,1087,396,1099,384,132,122,134,130,137,129,144,144,128,144,139,34.66503267973856,202007
四街道店,851,700,151,618,233,633,218,73,91,86,73,78,74,74,75,66,79,82,33.97428571428571,202007
国分寺店,999,804,195,738,261,738,261,79,73,93,92,99,110,106,81,90,88,88,34.19278606965174,202007
国立店,1406,1141,265,1049,357,1042,364,143,122,123,128,126,130,119,119,117,151,128,34.60999123575811,202007
坂戸店,1188,962,226,881,307,879,309,100,122,101,95,113,110,118,111,127,103,88,34.38149688149688,202007
墨田店,1004,822,182,747,257,743,261,86,97,97,77,87,93,91,90,94,106,86,33.475669099756686,202007
多摩店,1084,886,198,807,277,804,280,87,104,98,111,101,95,98,93,91,101,105,34.65462753950339,202007
大久保店,1064,856,208,758,306,788,276,91,108,100,94,95,102,101,99,91,96,87,34.75,202007
大井店,1212,1007,205,902,310,898,314,103,99,125,111,123,106,104,113,118,102,108,35.712015888778545,202007
大和店,1376,1121,255,1011,365,1021,355,127,114,122,120,118,133,128,119,117,151,127,33.92417484388938,202007
大塚店,1124,929,195,820,304,832,292,114,102,92,94,115,99,113,102,84,102,107,34.354144241119485,202007
大宮店,1375,1118,257,1010,365,1020,355,133,143,121,130,130,119,99,130,117,127,126,34.15652951699463,202007
大森店,1426,1134,292,1043,383,1059,367,125,108,128,126,156,150,135,135,108,124,131,35.313051146384474,202007
大泉店,1223,1006,217,922,301,906,317,118,112,110,119,108,116,112,106,91,119,112,34.139165009940356,202007
大田店,945,756,189,702,243,701,244,78,77,104,86,73,80,93,90,93,88,83,34.22222222222222,202007
太田店,1368,1142,226,1002,366,1015,353,109,113,113,135,132,128,137,108,131,127,135,34.6584938704028,202007
宇都宮店,1087,897,190,785,302,809,278,98,105,91,90,94,108,94,99,98,104,106,34.06020066889632,202007
守谷店,1178,950,228,850,328,872,306,115,112,113,102,92,99,110,97,101,112,125,34.43684210526316,202007
宮前店,724,602,122,513,211,535,189,71,63,63,65,66,60,62,74,70,61,69,35.03488372093023,202007
富岡店,1094,874,220,816,278,814,280,109,113,103,126,81,83,115,98,80,78,108,35.01029748283753,202007
富津店,1026,837,189,776,250,761,265,103,88,87,95,111,81,106,84,92,104,75,34.21385902031064,202007
富里店,1486,1223,263,1104,382,1098,388,121,135,124,145,147,129,163,148,139,121,114,34.311529026982825,202007
小山店,1035,854,181,750,285,767,268,87,107,99,101,71,86,94,93,96,105,96,34.14519906323185,202007
小平店,1004,839,165,735,269,745,259,85,84,103,100,92,92,97,93,85,87,86,33.921334922526825,202007
小田原店,910,741,169,685,225,672,238,82,90,93,91,82,76,80,82,75,69,90,33.44399460188934,202007
小金井店,1097,876,221,810,287,814,283,88,100,84,99,102,98,105,97,114,106,104,35.17009132420091,202007
川口店,1118,907,211,853,265,831,287,97,113,108,100,90,100,98,95,110,91,116,34.00441014332966,202007
川崎多摩店,1122,906,216,797,325,833,289,96,104,102,115,112,106,105,96,107,91,88,34.785871964679906,202007
川崎店,1212,985,227,907,305,906,306,111,103,100,118,94,128,103,126,113,104,112,41.245685279187825,202007
川越店,1154,955,199,836,318,854,300,113,102,109,105,111,101,84,111,94,104,120,40.70157068062827,202007
巣鴨店,1509,1213,296,1105,404,1120,389,175,145,136,110,126,160,141,145,125,123,123,34.34707337180544,202007
市原店,1185,965,220,862,323,877,308,116,112,102,106,119,118,102,122,99,100,89,34.84974093264249,202007
市川店,1179,952,227,880,299,877,302,100,118,105,119,115,121,99,91,100,102,109,41.07668067226891,202007
平塚店,1186,966,220,884,302,875,311,113,118,94,106,112,99,110,107,106,131,90,34.957556935817806,202007
幸店,1430,1162,268,1062,368,1062,368,137,134,116,140,131,111,111,131,151,126,142,34.81239242685026,202007
府中店,1250,1039,211,904,346,927,323,118,107,126,112,119,114,99,106,116,113,120,34.317613089509145,202007
座間店,1367,1121,246,1006,361,1011,356,136,140,113,117,130,121,131,122,131,110,116,34.24799286351472,202007
志木店,915,747,168,690,225,678,237,78,83,92,88,83,77,81,72,99,80,82,33.55689424364123,202007
恵比寿店,1036,851,185,753,283,768,268,85,78,98,89,86,90,95,106,96,99,114,20.52291421856639,202007
愛甲店,1060,863,197,765,295,787,273,102,89,87,92,103,113,91,93,90,95,105,34.14716106604867,202007
成城店,1373,1129,244,1043,330,1019,354,116,125,113,131,124,137,124,120,137,131,115,34.24712134632418,202007
成田店,881,713,168,662,219,656,225,77,76,72,88,86,70,101,70,86,94,61,34.218793828892004,202007
我孫子店,1124,913,211,821,303,831,293,108,88,92,98,108,108,106,110,109,98,99,20.42716319824753,202007
戸塚店,1556,1265,291,1127,429,1157,399,146,148,152,135,114,147,169,134,134,138,139,34.40790513833992,202007
戸田店,1548,1254,294,1180,368,1152,396,129,127,136,141,133,144,138,155,152,153,140,33.910685805422645,202007
所沢店,1189,998,191,876,313,883,306,103,111,117,89,111,118,122,95,109,114,100,34.43086172344689,202007
新宿店,1092,897,195,815,277,813,279,100,104,93,102,100,83,110,115,97,94,94,34.7056856187291,202007
新座店,1024,824,200,735,289,756,268,87,84,81,104,94,111,88,98,78,100,99,34.01820388349515,202007
日本橋店,1465,1159,306,1068,397,1088,377,136,142,128,108,154,136,124,143,142,138,114,34.677308024158755,202007
日立店,1310,1087,223,957,353,972,338,129,118,110,117,119,138,131,100,94,132,122,34.34130634774609,202007
日野店,1160,934,226,844,316,858,302,121,97,97,95,94,112,119,116,107,94,108,34.64882226980728,202007
旭店,1244,1017,227,919,325,921,323,116,115,114,118,97,130,115,111,119,99,110,34.62536873156342,202007
春日部店,1191,967,224,884,307,887,304,109,107,127,107,103,112,117,107,109,107,86,34.52223371251293,202007
昭島店,1213,992,221,898,315,899,314,107,110,130,104,104,103,104,125,99,125,102,34.26915322580645,202007
木更津店,1126,902,224,817,309,836,290,107,100,102,85,112,98,113,105,101,114,89,34.36252771618625,202007
本庄店,1186,979,207,868,318,879,307,131,87,119,86,101,121,122,99,130,93,97,34.57916241062309,202007
本郷店,757,612,145,565,192,563,194,63,61,64,73,64,70,65,64,64,88,81,41.27777777777778,202007
杉並店,1247,1014,233,925,322,921,326,124,101,99,121,113,103,119,120,110,122,115,34.3560157790927,202007
東中野店,1435,1145,290,1066,369,1066,369,125,128,131,141,121,149,124,134,127,141,114,34.55109170305677,202007
東久留米店,878,704,174,645,233,652,226,70,87,82,80,84,89,69,89,63,71,94,35.97869318181818,202007
東大和店,1102,928,174,816,286,819,283,99,96,100,103,101,92,97,100,114,98,102,34.47844827586207,202007
東尾久店,1209,968,241,908,301,895,314,112,109,96,127,105,103,105,113,111,113,115,34.889462809917354,202007
東村山店,1064,856,208,799,265,791,273,89,89,102,95,105,90,110,85,99,91,109,34.93808411214953,202007
東松山店,1337,1098,239,978,359,995,342,132,128,137,111,116,115,116,110,141,120,111,34.17486338797814,202007
松戸店,1246,1032,214,948,298,925,321,113,140,97,115,109,125,104,105,98,115,125,33.996124031007746,202007
板橋店,1089,869,220,827,262,804,285,100,92,94,90,102,94,101,108,95,99,114,40.58342922899885,202007
柏店,1521,1253,268,1145,376,1127,394,147,146,141,135,123,128,141,136,130,157,137,34.74940143655228,202007
栃木店,1099,886,213,827,272,815,284,80,107,94,102,110,103,85,106,103,104,105,33.988713318284425,202007
栄店,1579,1260,319,1165,414,1172,407,136,159,126,160,149,143,153,143,141,127,142,20.02936507936508,202007
桐生店,1243,994,249,931,312,920,323,127,110,107,116,111,99,134,126,111,92,110,34.40845070422535,202007
横浜南店,1427,1160,267,1069,358,1056,371,115,120,139,129,123,132,124,152,132,124,137,34.279310344827586,202007
横浜緑店,1304,1074,230,959,345,967,337,117,96,119,97,117,114,123,135,125,143,118,34.92271880819367,202007
横須賀店,1091,903,188,824,267,808,283,104,92,99,106,91,94,119,93,90,101,102,34.34772978959025,202007
武蔵村山店,1305,1080,225,959,346,972,333,97,124,122,126,114,131,115,131,119,103,123,34.28888888888889,202007
武蔵野店,1098,907,191,798,300,814,284,90,88,105,97,91,97,116,104,104,98,108,33.40242557883131,202007
水戸店,1408,1175,233,1031,377,1046,362,143,110,120,121,125,117,123,149,143,139,118,34.66723404255319,202007
江戸川店,1179,953,226,846,333,872,307,116,124,103,104,81,105,109,105,113,95,124,34.02938090241343,202007
江東店,1249,1017,232,951,298,926,323,90,110,133,120,119,133,98,120,109,109,108,34.30481809242871,202007
池尻店,1215,987,228,890,325,900,315,118,107,111,117,138,109,101,113,102,91,108,34.501519756838896,202007
池袋店,1458,1228,230,1072,386,1081,377,137,127,135,121,132,154,128,128,142,126,128,34.72475570032573,202007
泉店,1490,1237,253,1103,387,1104,386,133,133,125,156,161,103,133,137,128,145,136,35.324979789814066,202007
流山店,1519,1242,277,1101,418,1125,394,154,123,140,151,149,145,113,136,153,130,125,34.85426731078905,202007
浅草店,1394,1145,249,1054,340,1033,361,149,124,116,128,120,119,135,142,124,117,120,34.66899563318777,202007
浦和店,1309,1066,243,985,324,972,337,105,123,114,104,141,122,95,142,136,107,120,34.809568480300186,202007
浦安店,1337,1101,236,952,385,992,345,103,107,127,112,124,117,126,143,118,132,128,34.798365122615806,202007
海老名店,1193,986,207,858,335,885,308,112,113,113,112,109,107,107,115,96,100,109,34.545638945233264,202007
清瀬店,1063,854,209,811,252,789,274,101,97,102,76,96,101,90,101,104,96,99,35.2447306791569,202007
渋谷店,1155,943,212,849,306,856,299,102,103,103,98,102,89,116,133,101,97,111,34.732767762460234,202007
港北店,1033,843,190,777,256,765,268,93,83,92,101,102,98,115,84,92,91,82,20.775800711743774,202007
港南店,1251,1021,230,925,326,930,321,115,110,116,105,98,122,95,126,120,116,128,34.279138099902056,202007
瀬谷店,1460,1159,301,1065,395,1080,380,139,109,123,115,140,135,148,139,143,133,136,34.80327868852459,202007
熊谷店,1124,914,210,810,314,832,292,103,88,99,93,124,108,112,109,88,100,100,33.85995623632385,202007
狛江店,1244,1013,231,924,320,927,317,100,121,116,122,118,123,116,109,112,108,99,34.38203356367226,202007
狭山店,1428,1142,286,1084,344,1062,366,132,112,119,125,121,138,134,128,136,142,141,34.42907180385289,202007
王子店,1153,939,214,889,264,854,299,112,103,94,99,94,121,109,85,109,122,105,20.39403620873269,202007
町田店,1332,1095,237,974,358,989,343,129,113,114,129,123,136,112,109,129,115,123,34.59178082191781,202007
白井店,1094,889,205,837,257,813,281,104,106,103,84,100,97,94,109,111,101,85,39.9111361079865,202007
目黒店,1209,995,214,885,324,897,312,95,107,115,116,119,120,105,114,120,101,97,34.8070351758794,202007
相模原店,1489,1233,256,1075,414,1108,381,122,130,142,142,149,117,136,119,129,132,171,34.81508515815085,202007
石神井店,973,789,184,710,263,721,252,75,95,85,85,89,81,83,111,85,98,86,41.85044359949303,202007
磯子店,940,744,196,687,253,697,243,88,89,89,83,93,95,72,93,76,87,75,35.223118279569896,202007
神奈川店,1404,1156,248,1045,359,1041,363,130,123,141,125,136,114,145,129,116,128,117,34.74826989619377,202007
神田店,1455,1167,288,1073,382,1082,373,151,127,107,135,141,130,129,131,126,137,141,34.664952870608396,202007
福生店,1364,1105,259,1019,345,1013,351,143,114,125,115,122,123,116,131,126,115,134,33.68235294117647,202007
秦野店,1245,1017,228,917,328,924,321,113,107,113,122,99,117,121,109,131,113,100,34.024582104228124,202007
稲城店,964,785,179,744,220,717,247,68,88,104,79,93,80,87,93,88,92,92,41.914649681528665,202007
立川店,1316,1084,232,975,341,976,340,118,140,139,106,127,96,126,97,141,117,109,34.56273062730627,202007
綾瀬店,2691,2208,483,1968,723,1997,694,233,250,245,245,230,272,230,242,235,260,249,34.33876811594203,202007
練馬店,1438,1187,251,1064,374,1067,371,116,127,130,111,114,128,150,158,131,126,147,33.246840775063184,202007
羽村店,1398,1113,285,1052,346,1038,360,131,117,123,135,135,121,125,128,139,119,125,20.17340521114106,202007
羽生店,1341,1122,219,981,360,999,342,134,113,133,117,103,141,125,129,130,103,113,34.93939393939394,202007
習志野店,1435,1166,269,1068,367,1064,371,137,123,143,133,140,135,127,116,145,114,122,34.262435677530014,202007
自由が丘店,1314,1062,252,987,327,972,342,127,125,119,105,134,122,118,105,108,136,115,34.7984934086629,202007
船橋店,1470,1184,286,1088,382,1087,383,125,121,148,150,121,132,138,131,141,142,121,34.243243243243235,202007
若葉店,1183,937,246,888,295,878,305,100,102,101,132,116,103,103,101,108,98,119,34.14300960512273,202007
茂原店,1368,1106,262,1013,355,1014,354,92,125,127,136,117,133,124,136,131,113,134,33.78209764918625,202007
茅ヶ崎店,918,748,170,661,257,682,236,86,86,81,88,99,62,96,83,87,74,76,35.030748663101605,202007
草加店,998,815,183,730,268,744,254,99,110,71,101,87,89,112,87,85,81,76,34.54601226993865,202007
荒川店,910,752,158,671,239,677,233,72,91,84,88,95,82,82,86,73,75,82,34.40824468085106,202007
荻窪店,1250,1045,205,899,351,926,324,118,104,144,102,117,114,114,107,103,110,117,20.27081339712918,202007
葛飾店,1146,940,206,855,291,853,293,95,79,111,107,120,124,110,116,81,108,95,34.643617021276604,202007
蒲田店,1038,852,186,757,281,775,263,106,108,87,89,90,81,100,106,85,87,99,34.41431924882629,202007
藤沢店,1187,969,218,886,301,880,307,111,121,94,103,118,142,104,105,116,86,87,34.84829721362229,202007
行田店,1005,813,192,730,275,744,261,82,102,82,96,109,83,70,94,99,100,88,34.71955719557196,202007
西多摩店,1561,1300,261,1164,397,1158,403,142,132,162,162,116,138,133,147,139,128,162,34.99230769230769,202007
西東京店,998,818,180,740,258,745,253,87,85,92,116,80,79,90,82,94,99,94,34.26894865525672,202007
西葛西店,826,664,162,600,226,614,212,65,80,75,76,80,75,72,91,74,68,70,35.42620481927711,202007
調布店,1428,1177,251,1076,352,1059,369,117,125,122,107,158,137,154,121,139,131,117,34.2107051826678,202007
谷中店,1555,1256,299,1132,423,1156,399,133,149,161,139,161,152,142,149,144,117,108,34.25955414012739,202007
赤坂店,1033,845,188,779,254,765,268,103,87,93,100,86,104,81,77,102,99,101,34.856804733727806,202007
赤羽店,1191,980,211,904,287,886,305,118,101,115,132,107,113,92,88,111,115,99,40.97244897959184,202007
越谷店,909,758,151,682,227,676,233,86,85,81,88,97,66,65,90,95,79,77,41.46701846965699,202007
足利店,814,662,152,629,185,601,213,73,69,77,73,60,81,75,88,69,80,69,34.220543806646525,202007
足柄上店,1243,1001,242,900,343,920,323,112,106,129,108,116,121,126,101,103,114,107,34.86413586413586,202007
足立店,883,719,164,669,214,656,227,62,73,88,79,84,77,83,85,93,63,96,34.082058414464534,202007
逗子店,1094,902,192,817,277,809,285,113,84,93,105,104,106,94,103,104,94,94,34.43569844789357,202007
那珂店,1223,1009,214,894,329,907,316,115,128,116,116,98,109,115,102,97,122,105,20.498513379583745,202007
都筑店,1032,826,206,775,257,771,261,79,123,90,99,68,80,108,96,100,92,97,35.46125907990315,202007
金沢店,1275,1038,237,921,354,946,329,108,116,110,121,93,116,129,124,130,106,122,20.126204238921,202007
銀座店,1004,814,190,762,242,744,260,83,110,88,89,99,94,69,83,98,92,99,34.275184275184266,202007
鎌倉店,1005,830,175,746,259,746,259,99,100,89,89,90,81,85,94,90,98,90,34.818072289156625,202007
青山店,1371,1140,231,1020,351,1016,355,128,95,121,124,148,124,139,119,125,138,110,34.32456140350877,202007
青梅店,1277,1045,232,949,328,946,331,114,97,101,125,115,110,136,129,103,126,121,33.766507177033496,202007
青葉店,1161,965,196,864,297,860,301,110,101,92,97,108,134,107,107,92,104,109,34.54922279792746,202007
館林店,1191,974,217,883,308,884,307,122,105,120,97,110,102,103,104,99,119,110,34.322381930184804,202007
駒沢店,1035,851,184,778,257,764,271,82,101,76,102,88,108,96,96,104,91,91,34.83548766157462,202007
駒込店,1478,1228,250,1083,395,1094,384,137,138,133,142,137,136,133,112,135,142,133,34.52524429967427,202007
高円寺店,1426,1182,244,1073,353,1057,369,129,130,121,142,113,129,138,119,121,155,129,33.714043993231805,202007
高島平店,1248,1017,231,918,330,927,321,146,108,109,95,116,109,121,101,106,112,125,34.41002949852508,202007
高崎店,1157,921,236,832,325,859,298,111,112,106,103,117,112,110,100,92,96,98,34.22801302931596,202007
高座店,1164,977,187,872,292,864,300,110,104,99,128,76,110,94,122,102,115,104,34.860798362333675,202007
高津店,1154,918,236,844,310,855,299,105,111,92,109,120,96,104,99,107,117,94,34.58605664488017,202007
高田馬場店,1098,903,195,816,282,811,287,95,86,81,96,97,104,112,119,110,95,103,34.99557032115172,202007
鴻巣店,1153,970,183,870,283,861,292,107,94,114,104,112,100,102,104,106,114,96,34.58969072164948,202007
鶴見店,1524,1251,273,1125,399,1128,396,130,151,126,142,135,154,124,132,137,152,141,35.08153477218225,202007
麻生店,1397,1148,249,1046,351,1031,366,117,128,135,130,122,108,122,121,129,137,148,34.8719512195122,202007
あきる野店,1179,941,238,846,333,802,377,108,101,113,114,105,99,108,94,109,111,117,35.148777895855474,202008
さいたま南店,1540,1253,287,1110,430,1047,493,124,136,157,136,163,137,160,123,143,135,126,34.475658419792495,202008
さいたま緑店,1067,881,186,787,280,725,342,99,85,93,99,107,97,89,105,87,102,104,34.676503972758226,202008
さいたま西店,1216,987,229,891,325,822,394,100,107,103,111,98,131,111,115,108,119,113,35.13171225937183,202008
つくば店,1308,1067,241,958,350,886,422,113,133,129,118,130,103,120,125,102,109,126,35.01405810684161,202008
三浦店,1181,973,208,871,310,799,382,121,117,105,112,102,108,93,98,106,108,111,33.9825282631038,202008
三鷹店,1553,1265,288,1122,431,1050,503,160,127,134,139,141,131,133,155,137,154,142,34.48300395256917,202008
上尾店,1368,1127,241,1038,330,926,442,117,114,126,135,131,119,119,152,99,125,131,20.13220940550133,202008
上野店,1667,1372,295,1233,434,1132,535,172,150,152,149,140,148,150,145,177,117,167,34.650145772594755,202008
世田谷店,1582,1288,294,1169,413,1068,514,117,150,132,155,151,133,145,140,167,138,154,34.57996894409938,202008
中原店,1572,1278,294,1143,429,1061,511,145,145,133,150,136,157,129,146,136,139,156,34.876369327073554,202008
中店,1246,1028,218,914,332,845,401,132,99,116,117,104,117,101,105,123,131,101,34.19844357976654,202008
中野店,1186,963,223,868,318,801,385,127,105,126,104,108,101,96,100,106,112,101,34.27518172377985,202008
久喜店,1336,1084,252,1025,311,903,433,127,145,133,113,119,117,120,122,105,117,118,34.809963099631,202008
九段店,1366,1100,266,1016,350,925,441,120,139,126,115,118,124,130,116,129,118,131,33.45636363636363,202008
亀有店,1063,867,196,796,267,720,343,92,92,103,103,80,102,100,104,89,102,96,33.65974625144175,202008
五反田店,1180,935,245,865,315,798,382,99,124,103,94,110,101,103,115,126,107,98,35.46524064171123,202008
代々木店,1404,1138,266,1053,351,953,451,130,124,116,147,117,121,125,121,126,121,156,34.66432337434095,202008
伊勢原店,1491,1238,253,1105,386,1007,484,140,123,122,134,139,124,135,154,166,119,135,34.753634894991926,202008
伊勢崎店,1645,1360,285,1241,404,1119,526,158,176,154,155,144,166,142,126,148,137,139,35.06985294117647,202008
佐倉店,909,736,173,683,226,615,294,82,101,76,76,86,87,79,92,78,83,69,33.58152173913044,202008
佐野店,1562,1293,269,1152,410,1059,503,130,141,149,149,131,136,145,151,143,150,137,34.572312451662796,202008
保土ケ谷店,1313,1060,253,993,320,890,423,112,115,122,126,101,140,131,128,103,121,114,34.24716981132075,202008
入間店,1189,961,228,899,290,803,386,122,102,100,116,112,107,119,99,107,103,102,34.03746097814776,202008
八千代店,1270,1028,242,931,339,859,411,110,105,94,133,112,109,131,138,105,106,127,34.58560311284047,202008
八潮店,1259,1045,214,933,326,854,405,117,111,104,116,109,119,118,124,128,109,104,34.60956937799043,202008
八王子店,1579,1272,307,1155,424,1065,514,137,140,144,135,157,146,130,149,147,153,141,34.23977987421384,202008
六本木店,1026,839,187,776,250,694,332,74,99,91,101,102,94,85,101,89,85,105,34.30631704410012,202008
前橋店,845,693,152,624,221,575,270,67,62,87,85,77,68,76,66,91,79,87,34.3997113997114,202008
北千住店,1028,850,178,750,278,697,331,94,96,91,77,87,103,97,102,95,78,108,34.36705882352941,202008
千葉中央店,1312,1061,251,975,337,885,427,108,127,116,129,94,137,116,126,105,123,131,33.94721960414703,202008
千葉緑店,1183,936,247,907,276,805,378,97,116,111,103,108,112,106,114,96,121,99,34.63034188034188,202008
南砂店,1313,1059,254,982,331,890,423,127,114,124,118,123,113,129,110,120,122,113,35.08309726156752,202008
南足柄店,1039,832,207,763,276,704,335,86,103,92,93,94,107,89,98,99,81,97,33.84375,202008
厚木店,1486,1202,284,1096,390,1007,479,144,128,135,147,136,124,133,130,125,160,124,35.02079866888519,202008
取手店,1179,977,202,911,268,798,381,104,102,120,108,110,113,115,103,99,110,95,34.779938587512795,202008
向島店,1070,871,199,768,302,726,344,113,74,130,88,78,87,100,111,93,96,100,34.88404133180253,202008
君津店,1129,922,207,848,281,765,364,93,101,106,111,91,97,113,102,107,113,95,34.61930585683297,202008
和光店,1333,1104,229,976,357,898,435,124,124,129,119,104,113,131,112,130,118,129,34.77445652173913,202008
品川店,1492,1202,290,1121,371,1012,480,122,153,140,125,149,132,120,134,123,135,159,33.89767054908486,202008
四街道店,856,704,152,648,208,577,279,72,70,74,74,90,77,66,78,82,85,88,34.69176136363637,202008
国分寺店,998,798,200,725,273,673,325,77,93,89,95,93,81,90,105,105,84,86,34.63533834586466,202008
国立店,1395,1145,250,1009,386,946,449,123,127,133,138,132,125,133,108,109,131,136,34.866375545851525,202008
坂戸店,1182,983,199,892,290,799,383,105,105,101,111,101,103,111,123,95,116,111,34.025432349949135,202008
墨田店,1005,818,187,732,273,680,325,100,89,96,101,81,88,86,104,85,91,84,34.377750611246945,202008
多摩店,1098,907,191,820,278,748,350,100,96,108,96,86,103,101,107,106,103,92,34.36824696802646,202008
大久保店,1064,873,191,787,277,721,343,97,80,104,100,101,101,87,97,96,110,91,34.33218785796105,202008
大井店,1213,986,227,914,299,823,390,103,107,105,130,121,117,100,122,96,99,113,34.54361054766734,202008
大和店,1367,1131,236,1050,317,926,441,119,127,116,113,135,134,127,113,113,141,129,34.4580017683466,202008
大塚店,1126,911,215,860,266,762,364,104,92,104,110,90,92,103,112,105,97,117,33.63007683863886,202008
大宮店,1355,1124,231,992,363,916,439,123,105,144,126,124,109,129,123,107,134,131,34.50978647686833,202008
大森店,1426,1153,273,1040,386,971,455,115,123,157,131,125,125,128,124,136,141,121,34.58976582827407,202008
大泉店,1206,974,232,881,325,816,390,101,106,114,94,109,112,135,98,97,121,119,34.630390143737166,202008
大田店,940,762,178,691,249,638,302,88,75,98,84,80,77,85,82,98,80,93,33.85301837270341,202008
太田店,1368,1134,234,1007,361,927,441,133,124,144,127,119,120,111,124,112,123,131,34.904761904761905,202008
宇都宮店,1088,881,207,790,298,734,354,86,99,111,90,84,102,90,100,125,94,107,34.214528944381385,202008
守谷店,1179,958,221,863,316,798,381,98,95,119,115,124,107,116,89,111,94,111,33.94572025052192,202008
宮前店,728,578,150,544,184,494,234,73,60,77,58,81,54,54,65,69,71,66,34.1159169550173,202008
富岡店,1092,896,196,808,284,740,352,102,114,91,108,66,102,104,92,105,99,109,34.810267857142854,202008
富津店,1034,853,181,785,249,700,334,99,87,106,82,119,85,96,78,88,99,95,34.643610785463075,202008
富里店,1486,1197,289,1090,396,1007,479,144,121,134,121,131,127,141,132,134,151,150,34.89640768588137,202008
小山店,1033,850,183,762,271,697,336,84,106,93,101,89,94,98,79,88,91,110,34.47529411764706,202008
小平店,1004,824,180,743,261,683,321,72,94,92,87,87,95,94,103,76,104,100,35.06310679611651,202008
小田原店,914,755,159,676,238,619,295,96,84,79,78,88,92,72,78,87,91,69,33.83576158940397,202008
小金井店,1091,891,200,798,293,737,354,99,112,87,94,111,98,96,103,93,102,96,33.57687991021324,202008
川口店,1126,932,194,833,293,767,359,102,102,98,109,108,104,113,79,116,96,99,33.67918454935622,202008
川崎多摩店,1131,927,204,827,304,767,364,99,119,95,91,106,86,100,97,118,103,117,34.27831715210356,202008
川崎店,1215,998,217,913,302,820,395,119,116,103,108,102,99,116,109,96,113,134,34.13927855711423,202008
川越店,1156,951,205,851,305,781,375,106,111,122,97,105,100,112,98,94,110,101,34.03785488958991,202008
巣鴨店,1524,1249,275,1098,426,1033,491,129,140,139,127,146,142,149,149,120,142,141,34.83746997598078,202008
市原店,1182,956,226,847,335,803,379,105,108,93,107,123,126,98,112,99,106,105,34.38284518828452,202008
市川店,1198,962,236,894,304,811,387,111,117,89,97,100,121,109,109,119,104,122,35.515592515592516,202008
平塚店,1191,959,232,885,306,807,384,118,99,120,116,113,120,108,107,95,94,101,34.140771637122,202008
幸店,1428,1152,276,1076,352,967,461,141,138,133,139,135,127,120,136,126,125,108,33.6171875,202008
府中店,1243,995,248,912,331,841,402,100,115,122,94,128,131,114,106,110,104,119,34.562814070351756,202008
座間店,1370,1117,253,1023,347,930,440,124,116,135,119,129,124,134,118,118,118,135,34.53267681289167,202008
志木店,913,750,163,667,246,619,294,82,98,83,83,82,96,81,78,74,68,88,34.477333333333334,202008
恵比寿店,1038,864,174,790,248,704,334,91,95,96,80,103,89,107,105,88,91,93,19.619212962962962,202008
愛甲店,1056,862,194,767,289,717,339,97,97,79,96,82,106,93,88,107,107,104,34.18097447795824,202008
成城店,1364,1110,254,1031,333,927,437,125,113,103,125,137,131,143,133,119,120,115,34.02072072072072,202008
成田店,887,736,151,670,217,602,285,74,80,76,74,82,77,75,84,87,107,71,33.99728260869565,202008
我孫子店,1110,911,199,826,284,754,356,103,106,90,113,87,102,111,98,95,98,107,20.4390779363337,202008
戸塚店,1545,1291,254,1142,403,1047,498,131,144,145,147,138,138,154,137,145,130,136,34.657629744384195,202008
戸田店,1560,1276,284,1175,385,1054,506,135,122,146,156,143,159,109,133,132,186,139,34.96943573667711,202008
所沢店,1181,979,202,875,306,799,382,108,112,112,103,101,101,110,110,98,119,107,35.03779366700715,202008
新宿店,1087,897,190,798,289,737,350,91,102,99,98,91,105,112,96,94,109,90,33.6644370122631,202008
新座店,1025,835,190,779,246,694,331,83,95,105,90,109,86,83,101,100,86,87,34.705389221556885,202008
日本橋店,1461,1168,293,1065,396,991,470,130,134,132,126,134,137,126,110,134,138,160,34.45291095890411,202008
日立店,1314,1068,246,988,326,893,421,126,110,124,129,130,102,116,112,136,108,121,34.107677902621724,202008
日野店,1146,927,219,857,289,774,372,99,118,78,99,115,95,114,91,113,105,119,34.85976267529666,202008
旭店,1246,1018,228,933,313,841,405,117,104,113,110,133,108,123,119,108,108,103,34.30550098231827,202008
春日部店,1175,968,207,908,267,798,377,107,109,101,113,97,112,89,113,114,113,107,34.320247933884296,202008
昭島店,1214,980,234,909,305,820,394,97,95,117,112,103,121,120,113,128,101,107,34.446938775510205,202008
木更津店,1120,921,199,817,303,757,363,92,99,115,106,113,90,109,85,104,108,99,34.991313789359396,202008
本庄店,1186,995,191,886,300,808,378,114,113,112,100,119,115,103,105,99,94,112,34.68442211055277,202008
本郷店,763,637,126,555,208,519,244,76,65,62,62,69,75,62,74,64,78,76,33.97959183673469,202008
杉並店,1248,1026,222,926,322,846,402,109,127,118,113,126,123,102,92,116,106,116,32.94249512670565,202008
東中野店,1424,1156,268,1022,402,965,459,126,128,140,152,120,128,124,128,118,135,125,35.13667820069204,202008
東久留米店,874,706,168,680,194,592,282,70,87,87,82,86,78,73,78,75,74,84,34.936260623229465,202008
東大和店,1098,889,209,802,296,744,354,99,112,101,94,85,93,99,107,110,101,97,34.86614173228347,202008
東尾久店,1217,1013,204,906,311,822,395,108,98,110,107,123,98,116,106,110,121,120,34.056268509378086,202008
東村山店,1065,858,207,789,276,722,343,88,92,109,100,82,92,98,90,105,114,95,34.621212121212125,202008
東松山店,1334,1090,244,996,338,909,425,115,135,121,126,136,105,122,125,128,114,107,34.85321100917431,202008
松戸店,1245,1019,226,912,333,847,398,113,113,100,115,114,139,105,114,126,99,107,34.38076545632973,202008
板橋店,1097,897,200,788,309,740,357,103,98,104,87,103,103,107,104,104,92,92,34.163879598662206,202008
柏店,1525,1254,271,1154,371,1034,491,159,120,127,141,125,136,134,116,153,153,161,34.55263157894737,202008
栃木店,1087,878,209,791,296,736,351,95,109,86,98,97,99,97,105,112,78,111,34.71753986332574,202008
栄店,1574,1309,265,1167,407,1065,509,151,135,132,153,149,128,133,125,158,152,158,20.087853323147442,202008
桐生店,1252,1017,235,919,333,854,398,107,114,121,123,106,108,115,111,121,114,112,34.73549655850541,202008
横浜南店,1432,1160,272,1033,399,970,462,143,135,119,123,128,147,131,120,121,136,129,34.01293103448276,202008
横浜緑店,1306,1041,265,956,350,886,420,117,131,120,107,112,112,130,135,118,118,106,34.98847262247838,202008
横須賀店,1087,891,196,833,254,736,351,90,75,98,110,102,108,103,98,100,100,103,33.96296296296296,202008
武蔵村山店,1310,1053,257,963,347,889,421,114,132,147,97,104,115,116,120,117,122,126,34.329534662868,202008
武蔵野店,1093,900,193,808,285,743,350,93,100,99,108,111,102,105,101,85,81,108,34.215555555555554,202008
水戸店,1404,1160,244,1028,376,952,452,134,139,133,126,124,137,131,116,116,123,125,35.171551724137935,202008
江戸川店,1184,944,240,869,315,801,383,117,111,110,102,97,107,117,105,108,105,105,33.76377118644068,202008
江東店,1249,1009,240,929,320,847,402,119,120,116,121,116,108,118,104,99,105,123,34.97224975222993,202008
池尻店,1214,982,232,886,328,824,390,103,124,95,102,113,115,114,103,117,112,116,34.70264765784114,202008
池袋店,1452,1179,273,1058,394,986,466,147,133,132,126,119,152,124,134,118,149,118,34.80661577608142,202008
泉店,1489,1214,275,1129,360,1012,477,155,150,152,132,133,148,129,126,109,131,124,35.183690280065896,202008
流山店,1516,1257,259,1119,397,1026,490,126,139,137,132,134,137,137,158,126,162,128,34.3739061256961,202008
浅草店,1396,1123,273,1029,367,946,450,138,113,114,132,117,134,143,137,125,121,122,34.45592163846839,202008
浦和店,1297,1069,228,970,327,880,417,119,118,137,125,104,103,112,119,141,114,105,33.79607109448082,202008
浦安店,1338,1092,246,993,345,907,431,115,117,123,128,109,133,134,136,117,120,106,34.42948717948718,202008
海老名店,1190,945,245,885,305,805,385,122,110,104,103,112,125,100,101,110,112,91,34.76190476190476,202008
清瀬店,1067,879,188,764,303,726,341,109,95,98,110,84,84,91,112,96,98,90,35.01706484641638,202008
渋谷店,1160,967,193,859,301,787,373,108,104,93,104,116,113,110,108,88,111,105,34.641158221303,202008
港北店,1037,863,174,766,271,703,334,97,82,97,102,88,79,82,97,95,127,91,20.09617612977984,202008
港南店,1240,1021,219,907,333,840,400,100,128,116,110,119,90,129,105,119,103,121,33.89715964740451,202008
瀬谷店,1457,1206,251,1085,372,983,474,134,139,137,139,149,130,141,128,116,115,129,34.34162520729685,202008
熊谷店,1131,914,217,819,312,769,362,119,100,105,102,94,111,100,102,98,99,101,34.2691466083151,202008
狛江店,1254,1037,217,913,341,844,410,109,110,116,97,120,129,118,114,120,95,126,34.807135969141754,202008
狭山店,1433,1186,247,1033,400,971,462,120,104,130,120,124,144,135,128,145,140,143,34.49915682967959,202008
王子店,1164,943,221,864,300,789,375,115,96,107,110,114,114,101,88,95,106,118,20.05408271474019,202008
町田店,1334,1091,243,991,343,903,431,128,119,125,123,129,126,116,126,108,113,121,34.40421631530706,202008
白井店,1089,904,185,830,259,739,350,117,94,86,85,99,99,99,105,92,117,96,34.873893805309734,202008
目黒店,1214,989,225,886,328,824,390,98,117,109,111,113,129,122,95,107,122,91,34.424671385237616,202008
相模原店,1481,1226,255,1074,407,1004,477,141,133,140,153,128,131,122,119,142,146,126,34.04730831973899,202008
石神井店,979,802,177,737,242,666,313,95,77,82,100,81,93,97,88,87,90,89,33.51246882793018,202008
磯子店,941,771,170,682,259,642,299,75,74,84,96,71,93,81,96,80,91,100,34.961089494163424,202008
神奈川店,1398,1126,272,1035,363,949,449,144,134,130,118,123,109,134,121,120,130,135,33.99733570159858,202008
神田店,1462,1187,275,1081,381,989,473,127,138,130,169,131,152,114,135,130,107,129,34.60572872788543,202008
福生店,1362,1116,246,1032,330,918,444,95,126,132,151,96,135,141,107,130,113,136,34.23745519713262,202008
秦野店,1236,1007,229,912,324,839,397,92,91,105,109,127,128,118,113,104,125,124,34.22045680238332,202008
稲城店,978,808,170,706,272,660,318,93,90,89,84,102,73,92,84,87,90,94,34.34529702970297,202008
立川店,1304,1078,226,976,328,886,418,100,130,119,129,124,109,121,103,131,107,131,34.28014842300556,202008
綾瀬店,2711,2180,531,1998,713,1838,873,236,237,252,243,243,251,261,261,229,260,238,34.986697247706424,202008
練馬店,1425,1176,249,1036,389,968,457,131,138,124,127,154,135,121,140,117,122,116,33.43622448979592,202008
羽村店,1396,1150,246,1044,352,947,449,119,129,135,130,134,104,130,130,134,127,124,20.045217391304348,202008
羽生店,1336,1091,245,998,338,902,434,125,132,114,116,126,128,115,115,120,138,107,35.46379468377635,202008
習志野店,1425,1150,275,1048,377,966,459,124,119,148,134,135,123,124,132,123,125,138,34.96695652173913,202008
自由が丘店,1303,1072,231,973,330,875,428,120,110,134,126,123,130,110,101,122,106,121,34.906716417910445,202008
船橋店,1480,1202,278,1083,397,1003,477,136,145,105,128,147,163,124,140,129,150,113,34.24126455906822,202008
若葉店,1192,968,224,867,325,810,382,113,118,107,90,100,103,112,125,110,115,99,34.79132231404959,202008
茂原店,1371,1100,271,1017,354,932,439,129,125,112,132,136,130,125,110,118,123,131,34.801818181818184,202008
茅ヶ崎店,914,756,158,686,228,619,295,79,85,81,93,74,87,85,94,59,72,105,33.94973544973545,202008
草加店,1001,821,180,758,243,683,318,100,84,84,86,98,91,94,98,88,85,93,34.25091352009744,202008
荒川店,911,751,160,667,244,617,294,99,72,104,93,81,89,65,72,77,84,75,34.29560585885486,202008
荻窪店,1252,1007,245,936,316,845,407,106,116,116,109,120,117,109,106,124,117,112,20.48460774577954,202008
葛飾店,1141,922,219,846,295,769,372,91,99,130,102,87,112,111,109,99,96,105,34.42190889370933,202008
蒲田店,1034,849,185,738,296,698,336,77,110,82,116,98,103,72,94,99,87,96,33.76560659599529,202008
藤沢店,1192,962,230,881,311,808,384,114,102,101,101,103,110,135,98,115,102,111,34.858627858627855,202008
行田店,997,815,182,752,245,678,319,87,82,89,84,91,99,91,96,89,91,98,35.47361963190184,202008
西多摩店,1585,1293,292,1171,414,1075,510,158,151,149,137,149,132,139,155,140,130,145,34.06805877803558,202008
西東京店,1008,819,189,735,273,686,322,93,90,106,68,86,82,90,100,96,97,100,34.30402930402931,202008
西葛西店,816,641,175,619,197,552,264,74,73,73,78,68,72,75,80,74,72,77,35.68642745709828,202008
調布店,1431,1150,281,1074,357,969,462,121,128,114,136,128,137,132,144,146,122,123,34.40869565217391,202008
谷中店,1553,1269,284,1154,399,1052,501,99,121,157,153,149,161,131,140,143,160,139,34.71788810086682,202008
赤坂店,1029,854,175,771,258,695,334,85,89,92,98,89,104,87,100,101,96,88,34.38407494145199,202008
赤羽店,1188,981,207,878,310,805,383,109,103,96,111,104,115,100,120,107,116,107,34.72986748216106,202008
越谷店,906,735,171,694,212,612,294,92,65,78,84,83,75,81,89,78,71,110,35.2108843537415,202008
足利店,818,684,134,606,212,551,267,81,61,85,66,75,67,72,73,72,84,82,34.59795321637427,202008
足柄上店,1248,1017,231,914,334,850,398,105,116,100,123,126,112,124,111,120,109,102,35.22812192723697,202008
足立店,884,734,150,659,225,597,287,80,71,82,80,70,87,97,91,78,67,81,33.61035422343324,202008
逗子店,1091,894,197,816,275,742,349,107,82,90,112,94,119,94,96,89,104,104,34.60178970917226,202008
那珂店,1207,982,225,913,294,818,389,126,90,105,118,110,106,94,122,93,109,134,20.140529531568227,202008
都筑店,1031,838,193,784,247,699,332,87,94,97,99,80,91,89,100,116,94,84,34.64558472553699,202008
金沢店,1275,1028,247,931,344,862,413,119,113,128,123,124,117,116,84,115,118,118,20.195525291828794,202008
銀座店,1004,817,187,730,274,679,325,103,80,92,93,89,84,100,97,81,85,100,34.92533659730722,202008
鎌倉店,1000,824,176,733,267,676,324,83,92,87,91,90,90,99,99,88,78,103,34.6747572815534,202008
青山店,1366,1105,261,1032,334,920,446,116,134,141,107,105,152,101,125,124,138,123,34.64524886877828,202008
青梅店,1272,1019,253,945,327,859,413,122,100,129,97,124,113,115,121,106,126,119,34.85770363101079,202008
青葉店,1154,912,242,832,322,781,373,99,106,112,112,110,134,82,101,110,98,90,34.89364035087719,202008
館林店,1192,985,207,859,333,809,383,112,97,104,97,106,118,112,117,97,114,118,33.45482233502538,202008
駒沢店,1030,842,188,739,291,697,333,92,90,93,91,94,70,97,87,109,97,110,35.058194774346795,202008
駒込店,1496,1228,268,1120,376,1014,482,132,125,142,134,131,160,118,143,153,138,120,34.63599348534202,202008
高円寺店,1436,1160,276,1036,400,972,464,133,133,120,142,138,131,128,129,132,128,122,33.68362068965517,202008
高島平店,1246,1039,207,930,316,844,402,110,128,119,108,116,105,105,123,101,119,112,34.45909528392685,202008
高崎店,1157,944,213,866,291,785,372,111,107,82,96,99,104,114,106,103,103,132,34.01800847457627,202008
高座店,1160,974,186,863,297,785,375,106,97,80,101,108,130,112,111,92,115,108,34.29568788501027,202008
高津店,1153,926,227,857,296,784,369,96,93,107,104,99,118,108,107,109,109,103,35.518358531317496,202008
高田馬場店,1096,880,216,820,276,742,354,109,112,93,94,102,91,98,100,100,102,95,33.35227272727273,202008
鴻巣店,1152,940,212,844,308,783,369,106,95,103,113,101,108,108,98,116,112,92,34.7436170212766,202008
鶴見店,1515,1257,258,1114,401,1023,492,139,124,140,143,144,139,151,134,139,126,136,34.46141607000796,202008
麻生店,1383,1119,264,1023,360,940,443,113,127,124,119,119,122,128,131,139,131,130,34.45040214477212,202008
